𤭢	cw	ww
𰻝	bl	zx
嬢	nl	nf
薙	ti	cv
菈	la	cl
卻	qt	ge
濛	mg	du
诶	ei	yu
牠	ta	ny
咲	xn	kt
螓	qb	ih
珮	pw	wj
睆	hr	oy
挼	rx	fn
嗯	eg	kx
欸	ei	sq
哟	yo	ku
唷	yo	ko
育	yo	wo
啊	aa	kk
阿	aa	ek
吖	aa	ky
锕	aa	jk
腌	aa	od
爱	ai	vy
艾	ai	cx
哎	ai	kx
唉	ai	ku
哀	ai	yk
挨	ai	fu
埃	ai	tu
矮	ai	un
碍	ai	uc
暧	ai	oy
癌	ai	bu
蔼	ai	cr
隘	ai	em
皑	ai	bj
霭	ai	yr
嗳	ai	ky
嫒	ai	ny
毐	ai	tm
叆	ai	yy
瑷	ai	wy
砹	ai	ux
锿	ai	jk
嗌	ai	km
按	an	fn
安	an	bn
暗	an	oo
案	an	bm
岸	an	ug
俺	an	rd
黯	an	lo
庵	an	gd
鞍	an	gn
谙	an	yo
氨	an	qn
胺	an	on
鹌	an	dn
桉	an	mn
犴	an	qg
唵	an	kd
铵	an	jn
埯	an	td
盦	an	rm
垵	an	tn
𩽾	an	yn
昂	ah	oe
肮	ah	oj
盎	ah	ym
卬	ah	pe
傲	ao	rw
奥	ao	pd
熬	ao	fh
敖	ao	fw
澳	ao	dd
凹	ao	la
懊	ao	xd
嗷	ao	kw
拗	ao	fl
袄	ao	py
鳌	ao	fy
翱	ao	bx
獒	ao	fq
骜	ao	fm
坳	ao	tl
鏖	ao	lj
遨	ao	zw
媪	ao	nm
螯	ao	fi
岙	ao	yu
璈	ao	ww
鏊	ao	fj
聱	ao	fe
廒	ao	gw
奡	ao	bl
隩	ao	ed
薁	ao	cd
嶅	ao	fu
把	ba	fb
吧	ba	kb
八	ba	pn
爸	ba	fb
巴	ba	sl
罢	ba	sq
拔	ba	fy
霸	ba	yo
疤	ba	bb
跋	ba	zy
扒	ba	fb
叭	ba	kb
芭	ba	cb
靶	ba	gb
坝	ba	tb
耙	ba	lb
笆	ba	vb
魃	ba	gy
粑	ba	mb
钯	ba	jb
灞	ba	do
捌	ba	fd
鲅	ba	yy
岜	ba	ub
鲃	ba	yb
菝	ba	cy
蚆	ba	ib
胈	ba	oy
羓	ba	yb
朳	ba	mb
妭	ba	ny
白	bd	po
百	bd	ab
败	bd	bw
摆	bd	fq
拜	bd	uf
柏	bd	mb
掰	bd	uu
伯	bd	rb
佰	bd	rb
稗	bd	hu
捭	bd	fu
半	bj	bf
办	bj	lb
般	bj	vu
板	bj	my
班	bj	wl
伴	bj	rb
版	bj	py
搬	bj	fu
扮	bj	ff
斑	bj	ww
扳	bj	fy
瓣	bj	xg
绊	bj	sb
颁	bj	fy
拌	bj	fb
阪	bj	ey
坂	bj	ty
瘢	bj	bu
钣	bj	jy
癍	bj	bw
攽	bj	fw
柈	bj	mb
昄	bj	oy
湴	bj	dy
靽	bj	gb
𨭉	bj	wj
帮	bh	fj
膀	bh	of
邦	bh	fe
棒	bh	mf
绑	bh	se
榜	bh	mf
傍	bh	rf
磅	bh	uf
梆	bh	me
镑	bh	jf
谤	bh	yf
蚌	bh	if
浜	bh	db
蒡	bh	cf
玤	bh	wf
搒	bh	ff
塝	bh	tf
𠳐	bh	ke
保	bc	rm
报	bc	fy
包	bc	bs
宝	bc	by
抱	bc	fb
暴	bc	ou
爆	bc	hu
薄	bc	cc
堡	bc	rt
饱	bc	ub
豹	bc	vu
胞	bc	ob
剥	bc	ed
鲍	bc	yb
褒	bc	ym
刨	bc	bd
苞	bc	cb
鸨	bc	bn
曝	bc	ou
煲	bc	rh
葆	bc	cm
雹	bc	yb
褓	bc	pm
炮	bc	hb
龅	bc	vb
孢	bc	zb
趵	bc	zu
枹	bc	mb
瀑	bc	du
被	bw	pp
备	bw	wt
北	bw	lb
背	bw	bo
呗	bw	kb
杯	bw	mb
辈	bw	fi
悲	bw	fx
贝	bw	kr
倍	bw	rk
卑	bw	pu
惫	bw	wx
碑	bw	uu
狈	bw	qb
蓓	bw	ck
悖	bw	xz
孛	bw	uz
焙	bw	hk
邶	bw	be
陂	bw	ep
钡	bw	jb
褙	bw	po
碚	bw	uk
鞴	bw	gy
鐾	bw	uj
鹎	bw	pn
棓	bw	mk
糒	bw	my
琲	bw	wf
椑	bw	mu
臂	bw	uo
鞁	bw	gp
𬇙	bw	db
本	bf	ma
奔	bf	dc
笨	bf	vb
贲	bf	ub
苯	bf	cb
锛	bf	jc
畚	bf	st
犇	bf	nn
坌	bf	ft
倴	bf	rc
栟	bf	mk
夯	bf	dl
崩	bg	uo
蹦	bg	zo
绷	bg	so
迸	bg	zk
甭	bg	by
嘣	bg	ko
泵	bg	uu
镚	bg	jo
甏	bg	tw
琫	bg	wf
祊	bg	pf
比	bi	bb
必	bi	xp
毕	bi	bu
笔	bi	vm
避	bi	zx
闭	bi	mc
鼻	bi	zw
逼	bi	zt
壁	bi	ut
彼	bi	rp
碧	bi	wu
币	bi	pj
陛	bi	et
鄙	bi	ke
蔽	bi	cw
匕	bi	pv
毙	bi	bb
辟	bi	ux
婢	bi	nu
弊	bi	xc
璧	bi	uy
庇	bi	gb
敝	bi	xw
痹	bi	bw
弼	bi	gb
俾	bi	ru
裨	bi	pu
薜	bi	cx
哔	bi	ku
屄	bi	ub
愎	bi	xw
吡	bi	kb
跸	bi	zu
妣	bi	nb
篦	bi	vb
荜	bi	cu
狴	bi	qt
毖	bi	bb
蓖	bi	cb
嬖	bi	un
筚	bi	vu
髀	bi	gu
荸	bi	cz
濞	bi	dw
畀	bi	tw
赑	bi	bb
秕	bi	hb
箅	bi	vw
芘	bi	cb
佛	bi	rf
襞	bi	uy
苾	bi	cb
滗	bi	dm
铋	bi	jb
庳	bi	gu
萆	bi	cu
皕	bi	bb
咇	bi	kb
舭	bi	vb
沘	bi	db
珌	bi	wb
觱	bi	wy
诐	bi	yp
邲	bi	be
佖	bi	rb
馝	bi	hb
坒	bi	bt
泌	bi	db
秘	bi	hb
鲾	bi	yt
边	bm	zl
便	bm	rg
变	bm	wy
遍	bm	zc
编	bm	sc
辩	bm	xy
鞭	bm	gg
辨	bm	xl
扁	bm	hc
辫	bm	xs
贬	bm	bf
蝙	bm	ic
匾	bm	kc
卞	bm	wb
汴	bm	db
弁	bm	sc
砭	bm	uf
煸	bm	hc
褊	bm	pc
笾	bm	vl
鳊	bm	yc
昪	bm	oc
忭	bm	xb
苄	bm	cb
抃	bm	fb
碥	bm	uc
萹	bm	cc
𨚕	bm	se
表	bn	fy
标	bn	mu
镖	bn	ju
彪	bn	hp
飙	bn	qf
婊	bn	ny
骠	bn	mu
镳	bn	jh
膘	bn	ou
裱	bn	py
杓	bn	mu
飑	bn	fb
俵	bn	ry
鳔	bn	yu
摽	bn	fu
瘭	bn	bu
熛	bn	hu
藨	bn	ch
儦	bn	rh
骉	bn	mm
瀌	bn	dh
幖	bn	ju
脿	bn	oy
别	bp	kd
憋	bp	xx
瘪	bp	bl
鳖	bp	xy
蹩	bp	xz
癿	bp	bv
宾	bb	bb
彬	bb	mp
斌	bb	wv
滨	bb	db
鬓	bb	eb
缤	bb	sb
镔	bb	jb
濒	bb	dy
槟	bb	mb
殡	bb	db
膑	bb	ob
摈	bb	fb
玢	bb	wf
傧	bb	rb
豳	bb	uu
邠	bb	fe
髌	bb	gb
并	bk	bk
兵	bk	qb
冰	bk	du
病	bk	bn
柄	bk	mn
饼	bk	uk
禀	bk	wu
秉	bk	qr
丙	bk	an
炳	bk	hn
摒	bk	fk
屏	bk	uk
邴	bk	be
昺	bk	on
蛃	bk	in
波	bo	dp
博	bo	uc
脖	bo	oz
拨	bo	fy
播	bo	ft
勃	bo	ul
玻	bo	wp
膊	bo	oc
搏	bo	fc
驳	bo	mx
泊	bo	db
簸	bo	vp
帛	bo	bj
钵	bo	jb
跛	bo	zp
渤	bo	dl
菠	bo	cp
礴	bo	uc
啵	bo	kp
舶	bo	vb
卜	bo	ld
饽	bo	uz
铂	bo	jb
钹	bo	jy
箔	bo	vb
亳	bo	wq
擘	bo	uu
檗	bo	um
鹁	bo	un
僰	bo	ur
踣	bo	zk
镈	bo	jc
砵	bo	ub
鲌	bo	yb
哱	bo	kz
嶓	bo	ut
浡	bo	dz
馞	bo	hz
艴	bo	fb
蕃	bo	ct
欂	bo	mc
袯	bo	py
𬭛	bo	jp
不	bu	ab
部	bu	le
步	bu	vu
布	bu	uj
补	bu	pb
怖	bu	xj
捕	bu	ff
簿	bu	vc
埔	bu	tf
哺	bu	kf
埠	bu	tu
卟	bu	kb
逋	bu	zf
钚	bu	jb
晡	bu	of
瓿	bu	lw
醭	bu	yf
蔀	bu	ce
埗	bu	tu
𬷕	bu	fn
擦	ca	fu
嚓	ca	ku
才	cd	up
菜	cd	cc
彩	cd	cp
采	cd	vm
财	cd	bc
材	cd	mc
猜	cd	qo
蔡	cd	cu
裁	cd	gy
踩	cd	zc
睬	cd	oc
偲	cd	rx
参	cj	sp
残	cj	dj
惨	cj	xp
餐	cj	dg
灿	cj	hu
惭	cj	xj
蚕	cj	ti
璨	cj	wm
粲	cj	dm
骖	cj	mp
黪	cj	lp
䅟	cj	hp
藏	ch	ci
苍	ch	cv
仓	ch	rv
舱	ch	vv
沧	ch	dv
伧	ch	rv
鸧	ch	ln
草	cc	cu
操	cc	fm
肏	cc	rr
艹	cc	al
曹	cc	co
嘈	cc	ko
糙	cc	mk
槽	cc	mo
漕	cc	do
屮	cc	kl
芔	cc	cc
艚	cc	vo
螬	cc	io
𥕢	cc	uo
测	ce	dd
侧	ce	rd
册	ce	ka
策	ce	vu
厕	ce	id
恻	ce	xd
岑	cf	uv
涔	cf	dv
曾	cg	bo
层	cg	uy
蹭	cg	zo
噌	cg	ko
嶒	cg	uo
差	ia	yg
查	ia	md
察	ia	bu
茶	ia	cm
插	ia	fj
诧	ia	yq
叉	ia	yd
岔	ia	fu
茬	ia	ct
衩	ia	pi
碴	ia	ud
姹	ia	nq
杈	ia	mi
搽	ia	fm
刹	ia	xd
檫	ia	mu
槎	ia	mg
汊	ia	di
镲	ia	ju
锸	ia	jj
馇	ia	ud
垞	ia	tq
侘	ia	rq
猹	ia	qd
蹅	ia	zd
嵖	ia	ud
喳	ia	kd
𥻗	ia	md
拆	id	fi
柴	id	vm
钗	id	ji
豺	id	vc
侪	id	rq
茝	id	ci
虿	id	wi
瘥	id	bg
产	ij	wi
颤	ij	wy
缠	ij	sl
禅	ij	pu
蝉	ij	iu
搀	ij	fd
铲	ij	ji
婵	ij	nu
掺	ij	fp
阐	ij	mu
忏	ij	xq
馋	ij	ud
潺	ij	dz
蟾	ij	ik
谄	ij	yj
谗	ij	yd
孱	ij	uz
冁	ij	by
澶	ij	dd
觇	ij	vj
镡	ij	ju
羼	ij	uy
廛	ij	gt
巉	ij	ut
蒇	ij	cb
韂	ij	gk
躔	ij	zt
刬	ij	jd
浐	ij	di
襜	ij	pk
瀍	ij	dt
骣	ij	mz
镵	ij	jt
旵	ij	ou
啴	ij	ku
梴	ij	mv
儳	ij	rt
单	ij	bu
辿	ij	zu
𬊤	ij	hu
长	ih	pn
常	ih	xj
场	ih	tp
唱	ih	ko
厂	ih	ap
尝	ih	xy
昌	ih	oo
畅	ih	up
肠	ih	op
偿	ih	ry
敞	ih	xw
怅	ih	xi
倡	ih	ro
娼	ih	no
嫦	ih	nj
猖	ih	qo
昶	ih	yo
徜	ih	rk
氅	ih	xm
伥	ih	ri
裳	ih	xy
菖	ih	co
苌	ih	ci
阊	ih	mo
鬯	ih	kb
惝	ih	xk
鲳	ih	yo
鲿	ih	yy
𬬮	ih	ji
超	ic	tk
朝	ic	uo
潮	ic	do
吵	ic	ku
嘲	ic	ko
抄	ic	fu
炒	ic	hu
巢	ic	vg
钞	ic	ju
晁	ic	ov
焯	ic	hu
耖	ic	lu
怊	ic	xk
弨	ic	gk
绰	ic	su
车	ie	au
彻	ie	rd
扯	ie	fv
撤	ie	fw
澈	ie	dw
掣	ie	nu
砗	ie	ui
坼	ie	ti
尺	ie	un
㬚	ie	ow
沉	if	dj
陈	if	ed
臣	if	kl
晨	if	oi
尘	if	xt
趁	if	tp
辰	if	iy
衬	if	pc
嗔	if	kb
琛	if	wm
称	if	hx
宸	if	bi
忱	if	xe
抻	if	fu
碜	if	up
谌	if	yb
谶	if	yj
郴	if	me
棽	if	mv
瞋	if	ob
榇	if	mm
龀	if	vb
疢	if	bh
梣	if	mv
煁	if	hb
𬘭	if	sm
成	ig	wv
城	ig	ti
程	ig	hw
承	ig	ln
诚	ig	yi
盛	ig	im
乘	ig	qr
撑	ig	fu
呈	ig	kw
惩	ig	rx
丞	ig	la
澄	ig	db
逞	ig	zw
橙	ig	mb
骋	ig	mk
瞠	ig	ot
秤	ig	hp
铖	ig	ji
塍	ig	ot
琤	ig	wy
裎	ig	pw
澂	ig	dw
埕	ig	tw
柽	ig	mt
蛏	ig	it
酲	ig	yw
枨	ig	mi
珵	ig	ww
赪	ig	ib
偁	ig	rr
宬	ig	bi
牚	ig	xy
珹	ig	wi
憕	ig	xb
庱	ig	gw
晟	ig	oi
铛	ig	je
吃	ii	kv
持	ii	fc
迟	ii	zi
赤	ii	tb
痴	ii	bk
池	ii	dy
齿	ii	vr
斥	ii	jd
驰	ii	my
耻	ii	ev
翅	ii	vx
哧	ii	ki
炽	ii	hv
嗤	ii	ki
蚩	ii	ci
叱	ii	kb
弛	ii	gy
侈	ii	rx
啻	ii	wk
敕	ii	uw
螭	ii	in
魑	ii	gn
饬	ii	ul
笞	ii	vk
匙	ii	ob
踟	ii	zk
墀	ii	tn
豉	ii	dv
媸	ii	ni
褫	ii	pj
鸱	ii	un
彳	ii	pr
茌	ii	ct
篪	ii	vj
瘛	ii	bx
摛	ii	fn
眵	ii	ox
傺	ii	ru
漦	ii	wu
胣	ii	oy
瓻	ii	xw
痓	ii	bt
𫄨	ii	sj
冲	is	dv
充	is	wy
重	is	ql
虫	is	vd
崇	is	uu
宠	is	bl
忡	is	xv
憧	is	xl
铳	is	jy
舂	is	ij
艟	is	vl
翀	is	xv
茺	is	cy
珫	is	wy
漴	is	du
涌	is	dy
种	is	hv
㳘	is	dy
摏	is	fj
抽	iz	fy
仇	iz	rj
臭	iz	zq
丑	iz	vt
愁	iz	hx
筹	iz	vc
瞅	iz	oh
酬	iz	yv
绸	iz	sk
畴	iz	tc
踌	iz	zc
惆	iz	xk
稠	iz	hk
俦	iz	rc
雠	iz	ry
瘳	iz	bp
犨	iz	rn
帱	iz	jc
杻	iz	mi
侴	iz	rd
椆	iz	mk
出	iu	uu
处	iu	wb
楚	iu	mz
除	iu	em
初	iu	pd
触	iu	di
厨	iu	ic
础	iu	ui
储	iu	ro
畜	iu	xt
褚	iu	po
搐	iu	ft
橱	iu	mc
躇	iu	zo
雏	iu	dv
锄	iu	jl
矗	iu	uq
杵	iu	mw
楮	iu	mo
怵	iu	xu
黜	iu	li
绌	iu	si
蜍	iu	im
刍	iu	de
滁	iu	dm
樗	iu	mk
蹰	iu	zc
憷	iu	xz
亍	iu	ad
俶	iu	ry
斶	iu	ji
摴	iu	fk
䝙	iu	vq
䢺	iu	ie
濋	iu	dz
琡	iu	wy
𬺓	iu	vz
欻	ix	hq
揣	ik	fe
踹	ik	ze
搋	ik	fj
啜	ik	ky
传	ir	rv
穿	ir	by
船	ir	vk
川	ir	pl
喘	ir	ke
串	ir	kl
钏	ir	ji
椽	ir	mu
舛	ir	xf
遄	ir	ze
氚	ir	qi
床	il	gm
窗	il	bw
创	il	rd
疮	il	bv
闯	il	mm
怆	il	xv
幢	il	jl
噇	il	kl
吹	iv	kq
垂	iv	qt
锤	iv	jt
捶	iv	ft
炊	iv	hq
槌	iv	ml
陲	iv	et
棰	iv	mt
倕	iv	rt
圌	iv	ke
春	iy	io
纯	iy	st
唇	iy	ik
蠢	iy	ii
淳	iy	dz
醇	iy	yz
椿	iy	mo
鹑	iy	wn
莼	iy	ct
蝽	iy	io
瑃	iy	wo
䲠	iy	yo
堾	iy	to
𬭚	iy	jz
戳	io	xg
龊	io	vz
辍	io	iy
踔	io	zu
惙	io	xy
逴	io	zu
此	ci	vb
次	ci	dq
刺	ci	ud
词	ci	yk
辞	ci	ux
慈	ci	bx
赐	ci	bw
磁	ci	uy
伺	ci	rk
瓷	ci	dw
茨	ci	cq
雌	ci	vv
祠	ci	pk
呲	ci	kb
疵	ci	bb
泚	ci	db
糍	ci	my
鹚	ci	bn
茈	ci	cb
跐	ci	zb
玼	ci	wb
佽	ci	rq
兹	ci	by
莿	ci	cd
𫚖	ci	vy
从	cs	rr
匆	cs	bd
聪	cs	ex
丛	cs	ra
葱	cs	cx
琮	cs	wu
淙	cs	du
囱	cs	pw
骢	cs	mx
苁	cs	cr
枞	cs	mr
璁	cs	wx
熜	cs	hx
悰	cs	xu
凑	cz	dt
辏	cz	it
腠	cz	ot
粗	cu	mq
促	cu	rz
醋	cu	yo
簇	cu	vu
猝	cu	qu
蹙	cu	wz
蹴	cu	zy
卒	cu	wu
徂	cu	rq
殂	cu	dq
蔟	cu	cu
窜	cr	bi
蹿	cr	zi
篡	cr	vs
撺	cr	fi
攒	cr	fb
汆	cr	ru
爨	cr	jh
镩	cr	ji
脆	cv	ov
催	cv	rv
翠	cv	xu
崔	cv	uv
摧	cv	fv
粹	cv	mu
悴	cv	xu
璀	cv	wv
啐	cv	ku
萃	cv	cu
瘁	cv	bu
淬	cv	du
榱	cv	mv
毳	cv	mm
漼	cv	dv
缞	cv	sv
存	cy	uz
村	cy	mc
寸	cy	ud
忖	cy	xc
皴	cy	yp
邨	cy	te
错	co	jo
措	co	fo
挫	co	fr
搓	co	fg
撮	co	fy
磋	co	ug
蹉	co	zg
锉	co	jr
厝	co	io
矬	co	ur
嵯	co	ug
痤	co	br
鹾	co	bg
脞	co	or
瑳	co	wg
棤	co	mo
莝	co	cr
大	da	ar
打	da	fd
答	da	vk
达	da	zd
搭	da	fk
哒	da	kd
瘩	da	bk
嗒	da	kk
沓	da	uo
耷	da	de
鞑	da	gd
靼	da	gd
妲	da	nd
褡	da	pk
跶	da	zd
怛	da	xd
笪	da	vd
垯	da	td
溚	da	dk
炟	da	hd
荙	da	cd
鿎	da	ud
𨱏	da	jk
𫟼	da	jd
带	dd	cj
代	dd	ry
待	dd	rc
呆	dd	km
袋	dd	ry
戴	dd	gg
黛	dd	rh
歹	dd	ax
贷	dd	rb
逮	dd	zl
怠	dd	sx
殆	dd	dk
岱	dd	ru
玳	dd	wy
呔	dd	kt
傣	dd	ru
迨	dd	zk
绐	dd	sk
叇	dd	yl
埭	dd	tl
骀	dd	mk
轪	dd	id
垈	dd	rt
但	dj	rd
淡	dj	dh
担	dj	fd
弹	dj	gu
丹	dj	kd
蛋	dj	zi
胆	dj	od
旦	dj	oa
诞	dj	yv
耽	dj	ee
惮	dj	xu
石	dj	ak
眈	dj	oe
澹	dj	dk
掸	dj	fu
郸	dj	be
殚	dj	du
啖	dj	kh
氮	dj	qh
儋	dj	rk
聃	dj	er
箪	dj	vu
亶	dj	wd
疸	dj	bd
萏	dj	cj
瘅	dj	bu
疍	dj	zd
赕	dj	bh
憺	dj	xk
膻	dj	od
𫢸	dj	ru
𬘘	dj	se
当	dh	xe
党	dh	xx
荡	dh	cp
挡	dh	fe
档	dh	me
裆	dh	pe
宕	dh	bu
砀	dh	up
珰	dh	we
凼	dh	ku
谠	dh	yx
垱	dh	te
菪	dh	cu
筜	dh	ve
𣗋	dh	mx
𬍡	dh	dy
到	dc	gd
倒	dc	rd
道	dc	zz
刀	dc	vp
导	dc	sc
岛	dc	nu
盗	dc	dm
叨	dc	kd
蹈	dc	zj
祷	dc	pc
捣	dc	fu
稻	dc	hj
悼	dc	xu
纛	dc	fx
忉	dc	xd
氘	dc	ql
捯	dc	fd
鱽	dc	yd
舠	dc	vd
的	de	bu
地	de	ty
得	de	rc
德	de	rx
嘚	de	kc
锝	de	jc
扽	df	ft
等	dg	vc
灯	dg	hd
登	dg	bb
瞪	dg	ob
邓	dg	ye
凳	dg	bj
蹬	dg	zb
噔	dg	kb
镫	dg	jb
磴	dg	ub
戥	dg	og
嶝	dg	ub
璒	dg	wb
第	di	vd
弟	di	bd
底	di	gu
低	di	ru
帝	di	wj
敌	di	uw
抵	di	fu
递	di	zd
迪	di	zy
滴	di	dg
蒂	di	cj
狄	di	qh
笛	di	vy
嘀	di	kg
堤	di	tz
邸	di	ue
嫡	di	ng
棣	di	ml
缔	di	sj
谛	di	yj
涤	di	dm
荻	di	ch
娣	di	nd
诋	di	yu
氐	di	ud
砥	di	uu
镝	di	jg
睇	di	od
坻	di	tu
柢	di	mu
鞮	di	gz
羝	di	yu
觌	di	uj
籴	di	rm
骶	di	gu
碲	di	uj
禘	di	pj
翟	di	xv
踶	di	zz
菂	di	cu
髢	di	ey
玓	di	wu
杕	di	md
蹢	di	zg
媂	di	nj
提	di	fz
䃅	di	uu
䗖	di	ij
茋	di	cu
𤧛	di	wj
𬱖	di	yy
嗲	dx	kx
点	dm	vh
电	dm	ov
店	dm	gv
殿	dm	uu
典	dm	qb
颠	dm	uy
垫	dm	ft
甸	dm	bt
惦	dm	xv
奠	dm	bd
掂	dm	fv
癫	dm	by
巅	dm	uy
淀	dm	dz
滇	dm	db
玷	dm	wv
踮	dm	zv
佃	dm	rt
靛	dm	fz
碘	dm	ub
钿	dm	jt
簟	dm	vu
癜	dm	bu
坫	dm	tv
阽	dm	ev
扂	dm	hv
琔	dm	wz
掉	dn	fu
调	dn	yk
屌	dn	uj
雕	dn	kv
吊	dn	kj
钓	dn	ju
刁	dn	va
叼	dn	kd
貂	dn	vk
凋	dn	dk
碉	dn	uk
鲷	dn	yk
铫	dn	jv
铞	dn	jj
窎	dn	bn
汈	dn	dd
爹	dp	fx
蝶	dp	im
跌	dp	zf
叠	dp	yq
碟	dp	um
迭	dp	zf
谍	dp	ym
喋	dp	km
牒	dp	pm
堞	dp	tm
耋	dp	lt
鲽	dp	ym
昳	dp	of
蹀	dp	zm
瓞	dp	gf
垤	dp	tt
绖	dp	st
楪	dp	mm
𫶇	dp	uj
定	dk	bz
顶	dk	dy
丁	dk	al
盯	dk	od
订	dk	yd
叮	dk	kd
鼎	dk	po
钉	dk	jd
锭	dk	jz
町	dk	td
仃	dk	rd
酊	dk	yd
腚	dk	oz
玎	dk	wd
碇	dk	uz
疔	dk	bd
啶	dk	kz
耵	dk	ed
萣	dk	cz
丢	dq	pq
铥	dq	jq
动	ds	yl
东	ds	ax
洞	ds	dk
懂	ds	xv
冬	ds	wd
董	ds	cv
冻	ds	dd
栋	ds	md
咚	ds	kd
峒	ds	uk
胴	ds	ok
侗	ds	rk
恫	ds	xk
鸫	ds	dn
垌	ds	tk
硐	ds	uk
氡	ds	qd
胨	ds	od
岽	ds	ud
𬟽	ds	id
都	dz	le
斗	dz	ud
抖	dz	fd
豆	dz	ab
逗	dz	zb
兜	dz	pe
陡	dz	ez
窦	dz	bd
痘	dz	bb
蚪	dz	id
蔸	dz	ce
篼	dz	ve
钭	dz	jd
读	dz	yd
度	du	gy
独	du	qi
毒	du	fm
杜	du	mt
肚	du	ot
赌	du	bo
督	du	uo
渡	du	dy
嘟	du	ke
堵	du	to
妒	du	nh
睹	du	oo
笃	du	vm
渎	du	dd
镀	du	jy
犊	du	nd
牍	du	pd
蠹	du	gi
黩	du	ld
阇	du	mo
芏	du	ct
椟	du	md
髑	du	gi
厾	du	vq
𬭊	du	jt
断	dr	vj
段	dr	pu
短	dr	ub
端	dr	le
锻	dr	ju
缎	dr	su
煅	dr	hu
椴	dr	mu
耑	dr	ue
簖	dr	vj
塅	dr	tu
瑖	dr	wu
对	dv	yc
队	dv	er
堆	dv	tv
兑	dv	bx
怼	dv	yx
㨃	dv	fz
碓	dv	uv
祋	dv	pu
顿	dy	ty
盾	dy	io
蹲	dy	zc
敦	dy	ww
沌	dy	dt
遁	dy	zo
吨	dy	kt
钝	dy	jt
墩	dy	tw
炖	dy	ht
盹	dy	ot
惇	dy	xz
趸	dy	wz
礅	dy	uw
蹾	dy	zw
砘	dy	ut
镦	dy	jw
囤	dy	kt
多	do	xx
躲	do	um
朵	do	jm
夺	do	dc
堕	do	et
哆	do	kx
跺	do	zm
踱	do	zy
舵	do	vb
咄	do	ki
剁	do	jd
铎	do	jf
惰	do	xo
垛	do	tm
掇	do	fy
哚	do	km
裰	do	py
埵	do	tt
饳	do	ui
亸	do	wu
剟	do	yd
驮	do	md
㙍	do	ty
饿	ee	uw
呃	ee	kv
恶	ee	yx
额	ee	by
俄	ee	rw
愕	ee	xk
鹅	ee	wn
噩	ee	wk
娥	ee	nw
厄	ee	iv
峨	ee	uw
鄂	ee	ke
遏	ee	zr
扼	ee	fv
鳄	ee	yk
蛾	ee	iw
婀	ee	nk
讹	ee	yb
锷	ee	jk
颚	ee	ky
鹗	ee	kn
萼	ee	ck
屙	ee	uk
谔	ee	yk
垩	ee	yt
腭	ee	ok
莪	ee	cw
轭	ee	iv
苊	ee	cv
锇	ee	jw
崿	ee	uk
姶	ee	nk
涐	ee	dw
哦	ee	kw
堨	ee	tr
𥔲	ee	uk
𫫇	ee	kx
恩	en	yx
摁	en	fx
蒽	en	cx
而	er	al
儿	er	pv
二	er	aa
尔	er	dx
耳	er	ol
饵	er	ue
迩	er	zx
贰	er	yb
洱	er	de
珥	er	we
铒	er	je
鸸	er	en
陑	er	ee
鲕	er	ye
咡	er	ke
耏	er	ep
发	fa	fy
法	fa	dq
罚	fa	sd
乏	fa	pv
伐	fa	rg
阀	fa	mg
筏	fa	vg
砝	fa	uq
珐	fa	wq
垡	fa	rt
反	fj	iy
饭	fj	uy
翻	fj	cx
烦	fj	hy
凡	fj	jd
犯	fj	qv
范	fj	cv
番	fj	ct
繁	fj	px
返	fj	zy
泛	fj	df
帆	fj	jf
贩	fj	by
樊	fj	md
藩	fj	ct
梵	fj	mf
幡	fj	jt
蘩	fj	cx
璠	fj	wt
矾	fj	uf
畈	fj	ty
燔	fj	ht
钒	fj	jf
氾	fj	dv
蹯	fj	zt
墦	fj	tt
𫔍	fj	jt
𬸪	fj	cn
放	fh	fw
房	fh	hf
防	fh	ef
方	fh	wv
仿	fh	rf
芳	fh	cf
访	fh	yf
妨	fh	nf
坊	fh	tf
纺	fh	sf
肪	fh	of
舫	fh	vf
枋	fh	mf
昉	fh	of
鲂	fh	yf
邡	fh	fe
钫	fh	jf
牥	fh	nf
蚄	fh	if
飞	fw	vd
非	fw	ls
费	fw	fb
菲	fw	cf
废	fw	gy
妃	fw	nj
肥	fw	ob
啡	fw	kf
匪	fw	kf
沸	fw	df
肺	fw	oj
绯	fw	sf
斐	fw	fw
霏	fw	yf
翡	fw	fx
扉	fw	hf
吠	fw	kq
诽	fw	yf
蜚	fw	fi
狒	fw	qf
腓	fw	of
悱	fw	xf
淝	fw	db
芾	fw	cj
痱	fw	bf
榧	fw	mf
鲱	fw	yf
篚	fw	vf
朏	fw	oi
棐	fw	fm
镄	fw	jb
剕	fw	fd
𬴂	fw	mf
分	ff	bd
份	ff	rf
纷	ff	sf
奋	ff	dt
愤	ff	xb
粉	ff	mf
氛	ff	qf
吩	ff	kf
芬	ff	cf
焚	ff	mh
坟	ff	tw
忿	ff	fx
粪	ff	mg
汾	ff	df
酚	ff	yf
棼	ff	mf
偾	ff	rb
鲼	ff	yb
棻	ff	cm
鼢	ff	jf
翂	ff	xf
瀵	ff	dg
坋	ff	tf
豮	ff	ub
𣸣	ff	db
风	fg	jx
封	fg	tc
凤	fg	jy
峰	fg	uf
疯	fg	bf
锋	fg	jf
枫	fg	mf
丰	fg	sl
奉	fg	if
冯	fg	dm
缝	fg	sf
逢	fg	zf
讽	fg	yf
蜂	fg	if
烽	fg	hf
俸	fg	rf
沣	fg	df
沨	fg	df
酆	fg	ue
葑	fg	cc
唪	fg	kf
砜	fg	uf
赗	fg	bo
浲	fg	df
崶	fg	uc
否	fz	bk
缶	fz	wk
服	fu	oy
夫	fu	er
父	fu	bx
复	fu	pw
福	fu	pt
府	fu	gc
副	fu	ad
负	fu	db
付	fu	rc
富	fu	bt
妇	fu	ne
附	fu	ec
伏	fu	rq
傅	fu	rc
浮	fu	dz
扶	fu	ff
抚	fu	fw
符	fu	vc
肤	fu	of
腹	fu	ow
幅	fu	jt
咐	fu	kc
覆	fu	xw
腐	fu	gr
弗	fu	gl
赴	fu	tb
斧	fu	fj
俯	fu	rc
赋	fu	bv
辅	fu	if
芙	fu	cf
拂	fu	ff
甫	fu	uy
俘	fu	rz
缚	fu	sc
蝠	fu	it
敷	fu	fw
脯	fu	of
袱	fu	pq
腑	fu	oc
辐	fu	it
孚	fu	vz
驸	fu	mc
釜	fu	fb
苻	fu	cc
匐	fu	bt
宓	fu	bb
阜	fu	pu
孵	fu	lz
馥	fu	hw
茀	fu	cf
涪	fu	dk
茯	fu	cq
凫	fu	nj
蚨	fu	if
拊	fu	fc
蝮	fu	iw
讣	fu	yb
黼	fu	yf
趺	fu	zf
怫	fu	xf
氟	fu	qf
蜉	fu	iz
黻	fu	yy
麸	fu	ff
绂	fu	sy
跗	fu	zc
鲋	fu	yc
罘	fu	sb
滏	fu	db
郛	fu	ve
菔	fu	cy
桴	fu	mz
幞	fu	jf
祓	fu	py
呋	fu	kf
绋	fu	sf
莩	fu	cz
赙	fu	bc
鄜	fu	le
芣	fu	cb
洑	fu	dq
簠	fu	vm
榑	fu	mc
稃	fu	hz
韨	fu	wy
玞	fu	wf
砆	fu	uf
垺	fu	tz
㕮	fu	kf
㳇	fu	df
琈	fu	wz
𫓧	fu	jf
𫖯	fu	vy
尬	ga	yj
嘎	ga	kg
伽	ga	rk
噶	ga	kr
旮	ga	jo
咖	ga	kk
尕	ga	nx
尜	ga	xx
轧	ga	iv
钆	ga	jv
戛	ga	bg
该	gd	yr
改	gd	jw
盖	gd	ym
概	gd	mw
丐	gd	av
钙	gd	jg
溉	gd	dw
赅	gd	br
垓	gd	tr
陔	gd	er
戤	gd	ng
荄	gd	cr
晐	gd	or
𬮿	gd	ej
感	gj	wx
干	gj	au
敢	gj	ew
赶	gj	tg
甘	gj	ca
尴	gj	ym
杆	gj	mg
肝	gj	og
竿	gj	vg
橄	gj	mw
赣	gj	lb
秆	gj	hg
柑	gj	mg
擀	gj	fg
玕	gj	wg
淦	gj	dj
泔	gj	dg
矸	gj	ug
坩	gj	tg
绀	gj	sg
苷	gj	cg
旰	gj	og
疳	gj	bg
酐	gj	yg
澉	gj	dw
虷	gj	ig
鳡	gj	yx
㽏	gj	dg
刚	gh	kd
港	gh	ds
钢	gh	jx
岗	gh	ux
冈	gh	kx
缸	gh	fg
纲	gh	sx
罡	gh	sv
杠	gh	mg
肛	gh	og
筻	gh	vg
冮	gh	dg
矼	gh	ug
堽	gh	tv
戆	gh	lx
扛	gh	fg
㭎	gh	mx
鿍	gh	tf
高	gc	wk
告	gc	nk
搞	gc	fk
糕	gc	mh
稿	gc	hk
膏	gc	wo
羔	gc	yh
皋	gc	bu
镐	gc	jk
睾	gc	pg
篙	gc	vk
诰	gc	yk
槁	gc	mk
杲	gc	om
缟	gc	sk
锆	gc	jk
郜	gc	ne
藁	gc	cm
槔	gc	mu
筶	gc	vk
个	ge	rl
哥	ge	kk
各	ge	wk
格	ge	mk
歌	ge	kq
革	ge	cu
隔	ge	eg
阁	ge	mk
葛	ge	cr
割	ge	bd
胳	ge	ok
戈	ge	yp
搁	ge	fk
鸽	ge	rn
疙	ge	bv
骼	ge	gk
嗝	ge	kg
硌	ge	uk
咯	ge	kk
铬	ge	jk
鬲	ge	al
圪	ge	tv
蛤	ge	ik
舸	ge	vk
膈	ge	og
虼	ge	iv
袼	ge	pk
哿	ge	lk
镉	ge	jg
仡	ge	rv
饹	ge	uk
塥	ge	tg
滆	ge	dg
合	ge	rk
给	gw	sk
跟	gf	zg
根	gf	mg
亘	gf	ad
艮	gf	oy
哏	gf	kg
茛	gf	cg
更	gg	an
耿	gg	eh
哽	gg	kg
耕	gg	lj
羹	gg	yd
庚	gg	gr
梗	gg	mg
赓	gg	gb
埂	gg	tg
鲠	gg	yg
绠	gg	sg
浭	gg	dg
暅	gg	od
颈	gg	jy
鹒	gg	gn
𬒔	gg	uo
公	gs	bs
工	gs	aa
功	gs	gl
攻	gs	gw
宫	gs	bk
共	gs	cb
供	gs	rg
恭	gs	gx
弓	gs	vv
贡	gs	gb
躬	gs	ug
拱	gs	fg
龚	gs	lg
巩	gs	gf
蚣	gs	ig
觥	gs	dg
汞	gs	gu
肱	gs	os
珙	gs	wg
䢼	gs	ge
硔	gs	ug
够	gz	jx
狗	gz	qj
构	gz	mg
勾	gz	bs
购	gz	bg
沟	gz	dg
钩	gz	jg
苟	gz	cj
垢	gz	tk
篝	gz	vr
佝	gz	rj
媾	gz	nr
枸	gz	mj
诟	gz	yk
彀	gz	tu
缑	gz	su
遘	gz	zr
鞲	gz	gr
笱	gz	vj
觏	gz	fj
岣	gz	uj
姤	gz	nk
雊	gz	jv
耇	gz	lj
句	gz	bk
古	gu	uk
故	gu	gw
顾	gu	iy
股	gu	ou
姑	gu	ng
骨	gu	go
孤	gu	zg
谷	gu	bk
鼓	gu	tv
固	gu	kg
估	gu	rg
咕	gu	kg
辜	gu	gx
雇	gu	hv
蛊	gu	im
菇	gu	cg
汩	gu	do
箍	gu	vj
锢	gu	jg
沽	gu	dg
贾	gu	xb
鹘	gu	gn
臌	gu	ov
牯	gu	ng
轱	gu	ig
鸪	gu	gn
梏	gu	mk
痼	gu	bg
钴	gu	jg
毂	gu	tu
崮	gu	ug
诂	gu	yg
瞽	gu	to
菰	gu	cg
蛄	gu	ig
羖	gu	yu
觚	gu	dg
嘏	gu	gy
罟	gu	sg
榖	gu	tu
酤	gu	yg
馉	gu	uo
牿	gu	nk
堌	gu	tg
蓇	gu	co
鲴	gu	yg
呱	gu	kg
鹄	gu	nn
瀔	gu	du
𦙶	gu	og
挂	gx	ft
瓜	gx	in
刮	gx	ud
寡	gx	bf
卦	gx	tb
褂	gx	pb
剐	gx	kd
鸹	gx	un
诖	gx	yt
栝	gx	mu
胍	gx	og
怪	gk	xt
乖	gk	qb
拐	gk	fl
掴	gk	fy
夬	gk	vr
关	gr	bt
管	gr	vl
官	gr	bl
观	gr	yj
馆	gr	ul
惯	gr	xb
冠	gr	bc
贯	gr	mb
灌	gr	dv
罐	gr	fv
棺	gr	ml
倌	gr	rl
盥	gr	jm
掼	gr	fb
涫	gr	dl
鳏	gr	yx
鹳	gr	cn
瓘	gr	wv
祼	gr	pg
琯	gr	wl
毌	gr	ml
筦	gr	vy
蒄	gr	cc
爟	gr	hv
纶	gr	sl
莞	gr	cy
鳤	gr	yl
光	gl	xe
广	gl	di
逛	gl	zw
咣	gl	kg
犷	gl	qg
胱	gl	og
桄	gl	mg
洸	gl	dg
珖	gl	wg
垙	gl	tg
𨐈	gl	ig
鬼	gv	ps
贵	gv	vb
规	gv	fj
归	gv	le
跪	gv	zv
柜	gv	mj
诡	gv	yv
瑰	gv	wg
桂	gv	mt
龟	gv	dd
轨	gv	ij
闺	gv	mt
圭	gv	tt
桧	gv	my
刽	gv	rd
癸	gv	bt
硅	gv	ut
妫	gv	nw
珪	gv	wt
皈	gv	by
晷	gv	ok
鲑	gv	yt
刿	gv	ud
鳜	gv	yq
姽	gv	nv
簋	gv	vm
庋	gv	gv
宄	gv	bj
匦	gv	kj
邽	gv	te
鬶	gv	fg
炅	gv	oh
筀	gv	vt
滚	gy	dg
棍	gy	mb
衮	gy	yg
鲧	gy	yx
磙	gy	ug
辊	gy	ib
绲	gy	sb
过	go	zc
国	go	ky
果	go	tm
郭	go	we
锅	go	jn
裹	go	yg
蝈	go	iy
聒	go	eu
帼	go	jy
椁	go	mz
虢	go	vj
埚	go	tn
呙	go	kn
崞	go	uz
腘	go	oy
馘	go	ba
粿	go	mg
蜾	go	ig
馃	go	ug
涡	go	dn
𬇹	go	dy
哈	ha	kk
铪	ha	jk
还	hd	zb
海	hd	dm
孩	hd	zr
害	hd	bk
骇	hd	mr
嗨	hd	km
骸	hd	gr
亥	hd	wr
咳	hd	kr
嗐	hd	kk
氦	hd	qr
醢	hd	ym
胲	hd	or
咍	hd	kk
汉	hj	dy
寒	hj	bd
喊	hj	kk
韩	hj	uw
汗	hj	dg
含	hj	rk
涵	hj	du
翰	hj	ux
憾	hj	xx
罕	hj	bg
撼	hj	fx
悍	hj	xg
瀚	hj	dx
函	hj	ku
憨	hj	ex
旱	hj	og
酣	hj	yg
颔	hj	ry
邯	hj	ge
捍	hj	fg
鼾	hj	zg
晗	hj	ok
菡	hj	cu
焊	hj	hg
顸	hj	gy
邗	hj	ge
焓	hj	hk
蚶	hj	ig
扞	hj	fg
撖	hj	fw
暵	hj	ot
浛	hj	dk
琀	hj	wk
㘎	hj	kw
垾	hj	tg
崡	hj	uu
嵅	hj	uk
蔊	hj	cg
行	hh	rd
航	hh	vj
杭	hh	mj
沆	hh	dj
颃	hh	wy
绗	hh	sd
吭	hh	kj
巷	hh	gs
好	hc	nz
号	hc	kk
毫	hc	wm
豪	hc	wu
浩	hc	dk
耗	hc	lm
昊	hc	ot
郝	hc	ie
嚎	hc	ku
皓	hc	bk
壕	hc	tu
嗥	hc	ku
颢	hc	oy
濠	hc	du
蒿	hc	ck
灏	hc	dy
貉	hc	vk
蚝	hc	im
薅	hc	cc
皞	hc	bu
淏	hc	dt
嚆	hc	kk
鄗	hc	we
和	he	hk
何	he	rk
喝	he	kr
呵	he	kk
河	he	dk
赫	he	ii
核	he	mr
贺	he	lb
盒	he	rm
荷	he	ck
鹤	he	bn
禾	he	pm
褐	he	pr
嗬	he	kk
壑	he	bt
阖	he	mm
吓	he	kx
涸	he	dg
劾	he	wl
颌	he	ry
阂	he	mr
诃	he	yk
郃	he	re
纥	he	sv
龢	he	rh
鞨	he	gr
翮	he	gx
曷	he	or
龁	he	vv
盍	he	qm
菏	he	ck
盉	he	hm
饸	he	uk
熇	he	hk
鹖	he	on
翯	he	xk
垎	he	tk
隺	he	bv
𬌗	he	yk
黑	hw	lh
嘿	hw	kh
𬭶	hw	jh
很	hf	rg
狠	hf	qg
恨	hf	xg
痕	hf	bg
𬣳	hf	yg
哼	hg	kl
横	hg	mb
衡	hg	rd
恒	hg	xd
亨	hg	wl
蘅	hg	cd
珩	hg	wd
姮	hg	nd
桁	hg	md
鸻	hg	rn
堼	hg	tt
红	hs	sg
轰	hs	iy
洪	hs	dg
虹	hs	ig
宏	hs	bs
鸿	hs	dn
哄	hs	kg
弘	hs	gs
烘	hs	hg
泓	hs	ds
闳	hs	ms
讧	hs	yg
薨	hs	cb
訇	hs	bk
荭	hs	cg
纮	hs	ss
吽	hs	kn
竑	hs	ls
蕻	hs	cg
翃	hs	ux
黉	hs	xb
唝	hs	kb
玒	hs	wg
谼	hs	gg
𫟹	hs	jg
𬭎	hs	js
后	hz	ik
候	hz	ru
厚	hz	iz
吼	hz	kv
侯	hz	ru
猴	hz	qu
喉	hz	ku
逅	hz	zk
篌	hz	vu
瘊	hz	bu
鲎	hz	xy
堠	hz	tu
垕	hz	it
齁	hz	zj
骺	hz	gk
糇	hz	mu
郈	hz	ie
鲘	hz	yk
𬭤	hz	ju
乎	hu	pl
呼	hu	kh
忽	hu	wx
护	hu	fh
胡	hu	go
虎	hu	hj
湖	hu	do
糊	hu	mo
户	hu	du
互	hu	ah
狐	hu	qg
壶	hu	ty
蝴	hu	io
惚	hu	xx
弧	hu	gg
唬	hu	kj
葫	hu	co
沪	hu	dh
扈	hu	hb
瑚	hu	wo
琥	hu	wj
浒	hu	dw
斛	hu	dd
囫	hu	kw
祜	hu	pg
醐	hu	yo
唿	hu	kx
猢	hu	qo
笏	hu	vw
瓠	hu	dg
槲	hu	md
怙	hu	xg
煳	hu	ho
鹕	hu	gn
滹	hu	dh
觳	hu	tu
岵	hu	ug
烀	hu	hh
鄠	hu	ye
戽	hu	hd
縠	hu	tu
冱	hu	dh
鹱	hu	ny
淴	hu	dx
昒	hu	ow
鳠	hu	yy
嫭	hu	nh
轷	hu	ih
昈	hu	oh
话	hx	yu
花	hx	cb
化	hx	rb
华	hx	ru
划	hx	gd
画	hx	at
滑	hx	do
哗	hx	ku
猾	hx	qo
桦	hx	mu
骅	hx	mu
婳	hx	nt
铧	hx	ju
砉	hx	fu
觟	hx	dt
坏	hk	tb
怀	hk	xb
淮	hk	dv
槐	hk	mg
徊	hk	rk
踝	hk	zg
换	hr	fd
缓	hr	sy
环	hr	wb
幻	hr	yv
唤	hr	kd
欢	hr	yq
患	hr	ix
焕	hr	hd
桓	hr	md
鬟	hr	ey
宦	hr	bi
寰	hr	by
浣	hr	dy
痪	hr	bd
涣	hr	dd
奂	hr	dd
圜	hr	ky
豢	hr	ju
獾	hr	qv
洹	hr	dd
嬛	hr	ny
缳	hr	sy
萑	hr	cv
鲩	hr	yy
郇	hr	be
漶	hr	dx
逭	hr	zl
擐	hr	fy
锾	hr	jy
镮	hr	jy
澴	hr	dy
鹮	hr	sn
貆	hr	vd
峘	hr	ud
㬊	hr	oy
荁	hr	cd
𤩽	hr	wq
𬘫	hr	sy
黄	hl	cb
皇	hl	bw
晃	hl	og
慌	hl	xi
荒	hl	ci
恍	hl	xg
谎	hl	yi
惶	hl	xw
凰	hl	jw
煌	hl	hw
簧	hl	vb
徨	hl	rw
蝗	hl	iw
幌	hl	jg
潢	hl	db
璜	hl	wb
遑	hl	zw
磺	hl	ub
隍	hl	ew
肓	hl	wo
湟	hl	dw
蟥	hl	ib
篁	hl	vw
鳇	hl	yw
滉	hl	dg
喤	hl	kw
癀	hl	bb
锽	hl	jw
艎	hl	vw
瑝	hl	ww
媓	hl	nw
㿠	hl	bg
𨱑	hl	jb
会	hv	ry
回	hv	kk
挥	hv	fi
灰	hv	uh
慧	hv	fx
辉	hv	gi
恢	hv	xh
毁	hv	ju
悔	hv	xm
惠	hv	ix
汇	hv	dk
绘	hv	sy
徽	hv	rx
讳	hv	yw
晖	hv	oi
晦	hv	om
贿	hv	bo
秽	hv	hx
卉	hv	uc
麾	hv	gm
诲	hv	ym
蕙	hv	cx
彗	hv	fe
诙	hv	yh
喙	hv	ku
荟	hv	cy
烩	hv	hy
虺	hv	wi
蛔	hv	ik
珲	hv	wi
咴	hv	kh
茴	hv	ck
恚	hv	tx
洄	hv	dk
袆	hv	pw
隳	hv	ex
翚	hv	xi
翙	hv	ux
浍	hv	dy
蟪	hv	ix
硊	hv	uv
橞	hv	mx
哕	hv	kx
溃	hv	db
㧑	hv	fw
烠	hv	ho
𬤝	hv	yx
𬭬	hv	je
混	hy	db
婚	hy	no
魂	hy	yg
昏	hy	uo
浑	hy	di
荤	hy	ci
馄	hy	ub
诨	hy	yi
阍	hy	mo
溷	hy	du
惛	hy	xo
碈	hy	uo
或	ho	ga
活	ho	du
火	ho	br
伙	ho	rh
获	ho	cq
惑	ho	gx
货	ho	rb
祸	ho	pn
霍	ho	yv
豁	ho	bg
夥	ho	gx
嚯	ho	kv
藿	ho	cv
镬	ho	jy
蠖	ho	iy
攉	ho	fv
钬	ho	jh
嚄	ho	ky
锪	ho	jx
劐	ho	cd
濩	ho	dy
耠	ho	lk
漷	ho	de
㸌	ho	hv
佸	ho	ru
𬴃	ho	mu
级	ji	sj
集	ji	rm
几	ji	pv
及	ji	pn
机	ji	mj
记	ji	yj
季	ji	hz
击	ji	fk
急	ji	dx
鸡	ji	yn
挤	ji	fq
系	ji	px
即	ji	ge
既	ji	gw
极	ji	mj
计	ji	yu
激	ji	dw
继	ji	sm
基	ji	ct
寄	ji	bk
忌	ji	jx
己	ji	kv
际	ji	eu
纪	ji	sj
技	ji	fv
济	ji	dq
迹	ji	zb
吉	ji	tk
积	ji	hv
寂	ji	by
疾	ji	bu
姬	ji	ni
绩	ji	sb
祭	ji	xu
肌	ji	oj
辑	ji	ie
籍	ji	vo
圾	ji	tj
妓	ji	nv
嫉	ji	nu
饥	ji	uj
剂	ji	qd
奇	ji	dk
脊	ji	ro
稽	ji	ho
叽	ji	kj
唧	ji	ke
讥	ji	yj
藉	ji	co
冀	ji	bg
戟	ji	ug
棘	ji	uu
缉	ji	se
悸	ji	xz
羁	ji	sm
玑	ji	wj
伎	ji	rv
霁	ji	yq
矶	ji	uj
髻	ji	ek
稷	ji	hw
岌	ji	uj
汲	ji	dj
畸	ji	tk
笈	ji	vj
觊	ji	uj
骥	ji	mg
嵇	ji	hu
蓟	ji	cd
箕	ji	vb
佶	ji	rk
瘠	ji	bo
畿	ji	gt
犄	ji	nk
亟	ji	la
跻	ji	zq
殛	ji	da
暨	ji	gd
鲫	ji	ye
偈	ji	rr
齑	ji	qj
蒺	ji	cu
芨	ji	cj
屐	ji	uv
荠	ji	cq
楫	ji	me
赍	ji	ub
乩	ji	vv
麂	ji	lj
笄	ji	vk
芰	ji	cv
墼	ji	it
鹡	ji	rn
剞	ji	dd
戢	ji	ge
虮	ji	ij
伋	ji	rj
垍	ji	tz
掎	ji	fk
洎	ji	dz
跽	ji	zx
嵴	ji	uo
鲚	ji	yq
蕺	ji	ce
罽	ji	sd
蹐	ji	zo
姞	ji	nk
漈	ji	du
穄	ji	hu
耤	ji	lo
觭	ji	dk
惎	ji	cx
期	ji	co
鱾	ji	yj
㴔	ji	dx
堲	ji	gt
徛	ji	rk
枅	ji	mk
瀱	ji	dd
𪟝	ji	fl
𫌀	ji	pb
𫓯	ji	jt
𫓹	ji	jb
𬯀	ji	eq
𬶨	ji	gy
𬶭	ji	yu
加	jx	lk
家	jx	bu
价	jx	rj
假	jx	ry
架	jx	lm
甲	jx	ol
佳	jx	rt
夹	jx	ar
嘉	jx	tk
嫁	jx	nu
驾	jx	lm
颊	jx	jy
迦	jx	zk
茄	jx	ck
稼	jx	hu
枷	jx	mk
珈	jx	wk
袈	jx	ly
葭	jx	cy
浃	jx	dj
胛	jx	oj
痂	jx	bk
笳	jx	vk
岬	jx	uj
槚	jx	mb
钾	jx	jj
荚	jx	cj
郏	jx	je
铗	jx	jj
跏	jx	zk
蛱	jx	ij
恝	jx	fx
斝	jx	kd
镓	jx	ju
瘕	jx	by
泇	jx	dk
𬂩	jx	mj
见	jm	ke
间	jm	mo
件	jm	rn
剑	jm	qd
建	jm	zy
键	jm	jy
渐	jm	dj
简	jm	vo
坚	jm	lt
肩	jm	ho
箭	jm	vd
舰	jm	vj
尖	jm	xd
监	jm	lm
健	jm	ry
检	jm	mq
减	jm	dk
奸	jm	ng
艰	jm	yg
兼	jm	bb
鉴	jm	lj
贱	jm	bj
捡	jm	fq
剪	jm	bd
溅	jm	dj
践	jm	zj
荐	jm	cz
歼	jm	dq
拣	jm	fd
煎	jm	bh
俭	jm	rq
涧	jm	do
茧	jm	ci
谏	jm	yj
柬	jm	ur
笺	jm	vj
缄	jm	sk
戬	jm	yg
锏	jm	jo
碱	jm	uk
睑	jm	oq
翦	jm	bx
饯	jm	uj
蹇	jm	bz
僭	jm	ro
菅	jm	cl
毽	jm	my
腱	jm	oy
謇	jm	bk
蒹	jm	cj
戋	jm	ga
槛	jm	mm
鞯	jm	gz
笕	jm	vj
鹣	jm	jn
搛	jm	fj
缣	jm	sj
鞬	jm	gy
湔	jm	dd
裥	jm	po
枧	jm	mj
鲣	jm	yt
趼	jm	zk
谫	jm	yd
踺	jm	zy
楗	jm	my
暕	jm	oj
牮	jm	rn
篯	jm	vj
犍	jm	ny
鳒	jm	yj
𬣡	jm	yj
将	jl	lc
江	jl	dg
讲	jl	yj
降	jl	ef
蒋	jl	cc
奖	jl	ld
僵	jl	rj
姜	jl	yn
疆	jl	gj
匠	jl	kj
浆	jl	lu
酱	jl	ly
缰	jl	sj
绛	jl	sf
桨	jl	lm
犟	jl	gn
糨	jl	mi
豇	jl	dg
茳	jl	cg
礓	jl	uj
洚	jl	df
耩	jl	lr
膙	jl	oi
鳉	jl	yc
弶	jl	gx
强	jl	gi
叫	jn	kj
教	jn	lw
交	jn	wf
脚	jn	oe
角	jn	dy
较	jn	if
娇	jn	nl
焦	jn	rh
骄	jn	ml
轿	jn	il
搅	jn	fj
狡	jn	qf
郊	jn	we
胶	jn	of
觉	jn	xj
嚼	jn	kc
绞	jn	sf
剿	jn	vd
浇	jn	dw
缴	jn	sw
蛟	jn	if
椒	jn	my
侥	jn	rw
矫	jn	ul
饺	jn	uf
蕉	jn	ch
校	jn	mf
礁	jn	uh
皎	jn	bf
窖	jn	bk
跤	jn	zf
佼	jn	rf
姣	jn	nf
酵	jn	yz
鲛	jn	yf
艽	jn	cj
湫	jn	dh
醮	jn	yh
铰	jn	jf
峤	jn	ul
茭	jn	cf
徼	jn	rf
鹪	jn	rn
敫	jn	bw
噍	jn	kh
僬	jn	rh
峧	jn	uf
滘	jn	dk
燋	jn	hh
藠	jn	cb
皦	jn	bw
斠	jn	fd
璬	jn	ww
皭	jn	bc
恔	jn	xf
䴔	jn	wn
漖	jn	dw
接	jp	fn
解	jp	dn
姐	jp	nq
结	jp	sk
界	jp	tj
节	jp	ce
杰	jp	mh
街	jp	rt
借	jp	ro
介	jp	rl
阶	jp	ej
洁	jp	dk
戒	jp	gc
皆	jp	bb
劫	jp	ql
截	jp	gv
捷	jp	fz
揭	jp	fr
竭	jp	lr
届	jp	uy
婕	jp	nz
睫	jp	oz
诫	jp	yc
桀	jp	xm
芥	jp	cj
桔	jp	mk
诘	jp	yk
颉	jp	ty
嗟	jp	kg
孑	jp	la
羯	jp	yr
拮	jp	fk
秸	jp	hk
玠	jp	wj
碣	jp	ur
讦	jp	yg
疥	jp	bj
喈	jp	kb
蚧	jp	ij
疖	jp	be
絜	jp	fx
檞	jp	mn
劼	jp	tl
骱	jp	gj
鲒	jp	yk
褯	jp	pj
湝	jp	db
岊	jp	bu
楷	jp	mb
㛃	jp	fn
悈	jp	xc
蜐	jp	il
进	jb	zj
今	jb	rv
金	jb	rb
紧	jb	lx
近	jb	zj
尽	jb	id
仅	jb	ry
禁	jb	mu
劲	jb	jl
锦	jb	jj
巾	jb	kl
筋	jb	vl
津	jb	dy
晋	jb	yo
斤	jb	il
谨	jb	yw
浸	jb	dy
襟	jb	pu
矜	jb	mv
瑾	jb	ww
烬	jb	hd
靳	jb	gj
噤	jb	ku
觐	jb	cj
妗	jb	nv
缙	jb	so
堇	jb	cw
槿	jb	mw
衿	jb	pv
荩	jb	cd
馑	jb	uw
卺	jb	lv
瑨	jb	wo
廑	jb	gw
琎	jb	wj
赆	jb	bd
溍	jb	do
祲	jb	py
浕	jb	dd
墐	jb	tw
殣	jb	dw
珒	jb	wy
𬬱	jb	jj
经	jk	sj
惊	jk	xx
竟	jk	le
静	jk	fy
精	jk	mo
睛	jk	oo
警	jk	ck
京	jk	wx
境	jk	te
景	jk	ox
敬	jk	cw
镜	jk	je
晶	jk	oo
净	jk	dy
径	jk	rj
竞	jk	lx
井	jk	ac
靖	jk	lo
荆	jk	cd
菁	jk	co
阱	jk	ej
兢	jk	ux
憬	jk	xx
婧	jk	no
鲸	jk	yx
茎	jk	cj
丼	jk	jd
旌	jk	fu
痉	jk	bj
泾	jk	dj
迳	jk	zj
璟	jk	wx
胫	jk	oj
儆	jk	rw
靓	jk	fj
粳	jk	mg
獍	jk	qe
刭	jk	jd
腈	jk	oo
肼	jk	oj
倞	jk	rx
璥	jk	ww
麖	jk	lx
鼱	jk	jo
猄	jk	qx
䴖	jk	fn
汫	jk	dj
竫	jk	ly
囧	js	kk
炯	js	hk
窘	js	bk
迥	js	zk
颎	js	by
扃	js	hk
冏	js	kk
坰	js	tk
泂	js	dk
䌹	js	sk
𬳶	js	mk
就	jq	wy
九	jq	pv
酒	jq	dy
久	jq	pn
旧	jq	lo
救	jq	qw
究	jq	bj
舅	jq	jl
纠	jq	sj
疚	jq	bj
揪	jq	fh
咎	jq	wk
鹫	jq	wn
鸠	jq	jn
啾	jq	kh
臼	jq	pa
灸	jq	jh
赳	jq	tj
厩	jq	iw
柩	jq	mj
玖	jq	wj
韭	jq	fa
阄	jq	md
僦	jq	ry
鬏	jq	eh
桕	jq	mj
氿	jq	dj
㠇	jq	uy
巨	ju	kk
举	ju	xf
局	ju	uk
居	ju	ug
具	ju	qb
据	ju	fg
聚	ju	eu
剧	ju	ud
距	ju	zj
惧	ju	xb
拒	ju	fj
俱	ju	rb
矩	ju	uj
菊	ju	cm
拘	ju	fj
沮	ju	dq
鞠	ju	gm
狙	ju	qq
橘	ju	mk
驹	ju	mj
飓	ju	fb
锯	ju	jg
咀	ju	kq
踞	ju	zg
炬	ju	hj
掬	ju	fm
遽	ju	zu
倨	ju	rg
雎	ju	qv
钜	ju	jj
踽	ju	zy
裾	ju	pg
琚	ju	wg
疽	ju	bq
莒	ju	ck
車	ju	iu
龃	ju	vq
苣	ju	cj
榉	ju	mf
讵	ju	yj
苴	ju	cq
鞫	ju	gk
焗	ju	hk
椐	ju	mg
锔	ju	jk
筥	ju	vk
屦	ju	un
窭	ju	bn
醵	ju	yu
蒟	ju	cj
犋	ju	nb
澽	ju	du
娵	ju	ny
秬	ju	hj
崌	ju	ug
岠	ju	uj
砠	ju	uq
腒	ju	og
弆	ju	qc
泃	ju	dj
岨	ju	uq
趄	ju	tq
䴗	ju	on
𬶋	ju	yj
卷	jr	jv
娟	jr	no
倦	jr	rv
捐	jr	fo
眷	jr	jo
绢	jr	so
鹃	jr	kn
涓	jr	do
圈	jr	kv
隽	jr	rn
镌	jr	jn
蠲	jr	bi
狷	jr	qo
鄄	jr	xe
锩	jr	jv
桊	jr	jm
焆	jr	ho
绝	jt	sb
决	jt	dg
爵	jt	vc
诀	jt	yg
掘	jt	fi
厥	jt	iq
倔	jt	ri
撅	jt	fq
珏	jt	wy
崛	jt	ui
抉	jt	fg
噘	jt	kq
攫	jt	fy
谲	jt	yk
獗	jt	qq
蹶	jt	zq
傕	jt	rv
蕨	jt	cq
矍	jt	oy
橛	jt	mq
镢	jt	jq
玦	jt	wg
孓	jt	ln
桷	jt	my
觖	jt	dg
爝	jt	hc
劂	jt	id
玃	jt	qy
砄	jt	ug
㵐	jt	dq
𫔎	jt	jk
𫘝	jt	mg
均	jy	ty
君	jy	yk
军	jy	bi
俊	jy	rw
郡	jy	ye
峻	jy	uw
钧	jy	jy
骏	jy	mw
菌	jy	ch
竣	jy	lw
浚	jy	dw
珺	jy	wk
麇	jy	lh
皲	jy	bp
焌	jy	hw
葰	jy	cw
捃	jy	fk
畯	jy	tw
莙	jy	ck
晙	jy	ow
筠	jy	vy
鲪	jy	yk
䐃	jy	oh
卡	ka	ub
喀	ka	kk
咔	ka	kb
胩	ka	ob
开	kd	ac
凯	kd	uj
慨	kd	xw
铠	kd	jj
恺	kd	xj
揩	kd	fb
锴	kd	jb
忾	kd	xq
闿	kd	mj
剀	kd	ud
垲	kd	tj
锎	kd	jk
炌	kd	hj
蒈	kd	cb
看	kj	uo
堪	kj	tb
砍	kj	uq
刊	kj	gd
侃	kj	ri
坎	kj	tq
勘	kj	cl
阚	kj	mw
瞰	kj	ow
龛	kj	rl
戡	kj	cg
崁	kj	uq
莰	kj	cq
衎	kj	rg
磡	kj	ul
嵁	kj	ub
墈	kj	tl
抗	kh	fj
康	kh	gl
亢	kh	wj
炕	kh	hj
慷	kh	xl
糠	kh	ml
伉	kh	rj
钪	kh	jj
闶	kh	mj
𡐓	kh	tl
𩾌	kh	yl
靠	kc	nf
考	kc	lk
烤	kc	hk
铐	kc	jk
拷	kc	fk
犒	kc	nk
尻	kc	uj
栲	kc	mk
㸆	kc	hf
洘	kc	dk
可	ke	dk
刻	ke	wd
克	ke	ux
客	ke	bk
科	ke	hd
课	ke	yg
颗	ke	gy
渴	ke	dr
柯	ke	mk
棵	ke	mg
壳	ke	tj
氪	ke	qx
磕	ke	um
嗑	ke	km
珂	ke	wk
苛	ke	ck
轲	ke	ik
瞌	ke	om
坷	ke	tk
恪	ke	xk
蝌	ke	id
颏	ke	wy
窠	ke	bg
稞	ke	hg
溘	ke	dm
疴	ke	bk
岢	ke	uk
锞	ke	jg
髁	ke	gg
骒	ke	mg
缂	ke	sg
牁	ke	pk
匼	ke	kk
炣	ke	hk
剋	kw	ud
肯	kf	vo
恳	kf	gx
啃	kf	ko
垦	kf	gt
裉	kf	pg
坑	kg	tj
铿	kg	jt
硁	kg	uj
空	ks	bg
恐	ks	gx
控	ks	fg
孔	ks	zv
崆	ks	ug
箜	ks	vg
倥	ks	rg
硿	ks	ug
埪	ks	tg
口	kz	la
扣	kz	fk
寇	kz	by
叩	kz	ke
抠	kz	fq
蔻	kz	cy
芤	kz	cv
筘	kz	vk
眍	kz	oq
𫸩	kz	gq
苦	ku	cg
哭	ku	kq
酷	ku	yk
库	ku	gi
裤	ku	pi
枯	ku	mg
骷	ku	gg
窟	ku	bi
绔	ku	sk
喾	ku	xk
刳	ku	dd
矻	ku	uv
圐	ku	kf
夸	kx	dk
跨	kx	zk
垮	kx	tk
胯	kx	ok
挎	kx	fk
侉	kx	rk
姱	kx	nk
快	kk	xg
块	kk	tg
筷	kk	vg
蒯	kk	cd
哙	kk	ky
侩	kk	ry
脍	kk	oy
狯	kk	qy
郐	kk	re
鲙	kk	yy
㧟	kk	fk
宽	kr	bj
款	kr	tq
髋	kr	gj
况	kl	dx
狂	kl	qw
矿	kl	ug
旷	kl	og
眶	kl	ow
框	kl	mw
匡	kl	kw
筐	kl	vw
哐	kl	kw
邝	kl	ge
诳	kl	yw
诓	kl	yw
圹	kl	tg
纩	kl	sg
贶	kl	bx
夼	kl	di
洭	kl	dw
𫛭	kl	qn
亏	kv	ak
愧	kv	xg
盔	kv	um
魁	kv	gd
窥	kv	bj
奎	kv	dt
葵	kv	ct
傀	kv	rg
睽	kv	ot
馈	kv	ub
逵	kv	zt
馗	kv	jz
匮	kv	kb
喟	kv	ko
夔	kv	bw
篑	kv	vb
岿	kv	ue
揆	kv	ft
聩	kv	eb
跬	kv	zt
愦	kv	xb
悝	kv	xl
蝰	kv	it
暌	kv	ot
蒉	kv	cb
櫆	kv	md
骙	kv	mt
喹	kv	kt
煃	kv	ht
戣	kv	bg
𫠆	kv	vy
困	ky	km
昆	ky	ob
坤	ky	tu
捆	ky	fm
鲲	ky	yb
琨	ky	wb
锟	ky	jb
髡	ky	ew
阃	ky	mm
悃	ky	xm
堃	ky	ft
焜	ky	hb
壸	ky	ty
鹍	ky	on
裈	ky	pi
醌	ky	yb
婫	ky	nb
括	ko	fu
扩	ko	fg
阔	ko	mu
廓	ko	ge
蛞	ko	iu
拉	la	fl
啦	la	kl
辣	la	xu
垃	la	tl
腊	la	oo
喇	la	kd
蜡	la	io
落	la	ck
揦	la	fd
剌	la	ud
邋	la	zv
旯	la	oj
瘌	la	bd
砬	la	ul
镴	la	jv
蝲	la	id
鞡	la	gl
𬶟	la	yd
来	ld	am
莱	ld	cl
赖	ld	ub
籁	ld	vb
睐	ld	ol
癞	ld	bb
濑	ld	db
徕	ld	rl
崃	ld	ul
涞	ld	dl
赉	ld	lb
俫	ld	rl
铼	ld	jl
梾	ld	ml
蓝	lj	cm
烂	lj	hl
懒	lj	xb
拦	lj	fl
篮	lj	vm
岚	lj	uf
兰	lj	bs
栏	lj	ml
览	lj	lj
澜	lj	dj
揽	lj	fj
滥	lj	dm
婪	lj	mn
阑	lj	mj
榄	lj	mj
斓	lj	wj
缆	lj	sj
褴	lj	pm
谰	lj	yj
罱	lj	sg
襕	lj	pj
镧	lj	jj
漤	lj	dn
𬒗	lj	uj
狼	lh	ql
浪	lh	dl
郎	lh	le
朗	lh	lo
廊	lh	ge
螂	lh	ie
琅	lh	wl
啷	lh	ke
榔	lh	me
锒	lh	jl
阆	lh	ml
烺	lh	hl
蒗	lh	cl
莨	lh	cl
稂	lh	hl
崀	lh	ul
㫰	lh	ol
㮾	lh	lm
埌	lh	tl
塱	lh	lt
桹	lh	ml
筤	lh	vl
蓢	lh	co
老	lc	lb
劳	lc	cl
牢	lc	bn
姥	lc	nl
捞	lc	fl
唠	lc	kl
佬	lc	rl
烙	lc	hk
酪	lc	yk
涝	lc	dl
崂	lc	ul
嫪	lc	np
痨	lc	bl
醪	lc	yp
栳	lc	ml
铑	lc	jl
耢	lc	ll
荖	lc	cl
铹	lc	jl
络	lc	sk
𫭼	lc	tl
了	le	al
乐	le	px
勒	le	gl
叻	le	kl
泐	le	dl
鳓	le	yl
仂	le	rl
簕	le	vl
嘞	le	kl
雷	lw	yt
类	lw	md
泪	lw	do
累	lw	tx
蕾	lw	ct
磊	lw	uu
垒	lw	st
擂	lw	ft
肋	lw	ol
儡	lw	rt
镭	lw	jt
羸	lw	wy
檑	lw	mt
耒	lw	fm
诔	lw	yl
嫘	lw	nx
酹	lw	yc
缧	lw	sx
礌	lw	ut
罍	lw	tf
藟	lw	ct
癗	lw	bt
冷	lg	ds
愣	lg	xf
楞	lg	mf
棱	lg	mw
塄	lg	tf
崚	lg	uw
堎	lg	tw
里	li	tt
力	li	vp
离	li	wn
李	li	mz
理	li	wl
立	li	wb
利	li	hd
梨	li	hm
丽	li	ad
历	li	il
礼	li	pv
厉	li	iw
例	li	rd
莉	li	cd
黎	li	hu
璃	li	wn
励	li	il
哩	li	kl
狸	li	ql
粒	li	ml
隶	li	yu
吏	li	gn
栗	li	xm
漓	li	dn
雳	li	yl
厘	li	il
俐	li	rd
笠	li	vl
沥	li	dl
篱	li	vn
戾	li	hq
鲤	li	yl
犁	li	hn
砾	li	ul
荔	li	cl
砺	li	uw
郦	li	le
藜	li	cu
骊	li	md
俪	li	rd
鹂	li	ln
蠡	li	hi
栎	li	ml
唳	li	kq
喱	li	kl
罹	li	sv
痢	li	bd
莅	li	cl
俚	li	rl
逦	li	zd
呖	li	kl
蛎	li	iw
猁	li	qd
澧	li	db
醴	li	yb
娌	li	nl
蓠	li	cn
詈	li	sk
黧	li	hh
蜊	li	id
缡	li	sn
傈	li	rm
枥	li	ml
溧	li	dm
坜	li	tl
疠	li	bw
粝	li	mw
嫠	li	wn
锂	li	jl
篥	li	vm
轹	li	il
鲡	li	yd
疬	li	bl
苈	li	cl
浬	li	dl
跞	li	zl
浰	li	dd
鳢	li	yb
醨	li	yn
凓	li	dm
朸	li	ml
㰀	li	mu
珕	li	wl
𫵷	li	ul
𬍛	li	wl
俩	lx	rl
连	lm	zi
脸	lm	oq
联	lm	et
练	lm	sd
恋	lm	wx
怜	lm	xs
炼	lm	hd
莲	lm	ci
链	lm	ji
帘	lm	bj
廉	lm	gj
敛	lm	qw
涟	lm	di
镰	lm	jj
琏	lm	wi
濂	lm	dj
潋	lm	dw
殓	lm	dq
奁	lm	dq
裢	lm	pi
楝	lm	mj
裣	lm	pq
鲢	lm	yi
梿	lm	mi
蠊	lm	ij
蔹	lm	cw
瑓	lm	wj
𬶠	lm	yj
两	ll	ar
量	ll	ol
亮	ll	wj
良	ll	dg
凉	ll	dx
梁	ll	dm
辆	ll	il
粮	ll	ml
谅	ll	yx
踉	ll	zl
晾	ll	ox
粱	ll	dm
魉	ll	gl
椋	ll	mx
辌	ll	ix
墚	ll	tm
悢	ll	xl
俍	ll	rl
𫟅	ll	sx
𬜯	ll	cl
聊	ln	ee
料	ln	md
疗	ln	bl
辽	ln	zl
廖	ln	gp
撩	ln	fx
寥	ln	bp
僚	ln	rx
缭	ln	sx
燎	ln	hx
撂	ln	fk
獠	ln	qx
潦	ln	dx
镣	ln	jx
嘹	ln	kx
瞭	ln	ox
寮	ln	bx
蓼	ln	cp
尥	ln	yu
鹩	ln	dn
嫽	ln	nx
髎	ln	gp
钌	ln	jl
蹽	ln	zx
漻	ln	dp
憭	ln	xx
簝	ln	vx
橑	ln	mx
𪤗	ln	tp
列	lp	dd
裂	lp	dy
猎	lp	qo
咧	lp	kd
烈	lp	dh
劣	lp	ul
冽	lp	dd
趔	lp	td
洌	lp	dd
鬣	lp	ev
捩	lp	fq
埒	lp	tc
躐	lp	zv
峛	lp	ud
脟	lp	oc
䴕	lp	dn
𫚭	lp	yv
林	lb	mm
临	lb	lk
琳	lb	wm
淋	lb	dm
邻	lb	re
麟	lb	lf
凛	lb	du
拎	lb	fs
霖	lb	ym
鳞	lb	yf
吝	lb	wk
躏	lb	zv
粼	lb	mv
磷	lb	uf
嶙	lb	uf
蔺	lb	cv
赁	lb	rb
懔	lb	xu
辚	lb	if
遴	lb	zf
廪	lb	gu
潾	lb	df
檩	lb	mu
璘	lb	wf
啉	lb	km
瞵	lb	of
膦	lb	of
翷	lb	mx
箖	lb	vm
𬭸	lb	jf
𬴊	lb	mf
令	lk	rs
灵	lk	eh
领	lk	ry
另	lk	kl
凌	lk	dw
玲	lk	ws
零	lk	ys
龄	lk	vs
铃	lk	js
陵	lk	ew
岭	lk	us
菱	lk	cw
伶	lk	rs
聆	lk	es
翎	lk	rx
绫	lk	sw
〇	lk	vv
羚	lk	ys
呤	lk	ks
苓	lk	cs
泠	lk	ds
棂	lk	mh
瓴	lk	rw
酃	lk	ye
囹	lk	ks
鲮	lk	yw
蛉	lk	is
鸰	lk	rn
柃	lk	ms
舲	lk	vs
澪	lk	ds
昤	lk	os
祾	lk	pw
姈	lk	ns
㥄	lk	xw
坽	lk	ts
流	lq	di
刘	lq	wd
留	lq	pt
六	lq	wb
柳	lq	me
溜	lq	dt
琉	lq	wi
榴	lq	mt
浏	lq	dd
瘤	lq	bt
硫	lq	ui
遛	lq	zt
陆	lq	ej
绺	lq	sk
鎏	lq	dj
馏	lq	ut
骝	lq	mt
镏	lq	jt
旒	lq	fi
镠	lq	jp
锍	lq	ji
熘	lq	ht
鹨	lq	xn
飗	lq	ft
瑬	lq	dy
珋	lq	we
罶	lq	st
鹠	lq	pn
疁	lq	tp
碌	lq	uu
龙	ls	yp
隆	ls	eu
笼	ls	vl
拢	ls	fl
胧	ls	ol
珑	ls	wl
咙	ls	kl
聋	ls	le
垄	ls	lt
窿	ls	bu
陇	ls	el
泷	ls	dl
茏	ls	cl
眬	ls	ol
栊	ls	ml
砻	ls	lu
哢	ls	kc
昽	ls	ol
癃	ls	bu
漋	ls	du
弄	ls	wc
𬕂	ls	vb
楼	lz	mn
搂	lz	fn
漏	lz	dy
髅	lz	gn
露	lz	yk
陋	lz	en
喽	lz	kn
娄	lz	mn
篓	lz	vn
镂	lz	jn
偻	lz	rn
蝼	lz	in
耧	lz	ln
蒌	lz	cn
瘘	lz	bn
嵝	lz	un
溇	lz	dn
䁖	lz	on
剅	lz	dd
𦝼	lz	on
𪣻	lz	tn
路	lu	zk
鲁	lu	yo
录	lu	eu
撸	lu	fo
卢	lu	bu
鹿	lu	gb
炉	lu	hh
芦	lu	ch
禄	lu	pu
虏	lu	hl
璐	lu	wk
噜	lu	ko
戮	lu	xg
颅	lu	by
庐	lu	gh
漉	lu	dl
掳	lu	fl
辘	lu	il
赂	lu	bk
麓	lu	ml
卤	lu	bx
鹭	lu	zn
泸	lu	du
潞	lu	dk
橹	lu	mo
辂	lu	ik
箓	lu	vu
胪	lu	ou
鲈	lu	yu
轳	lu	iu
垆	lu	tu
渌	lu	du
逯	lu	zu
鸬	lu	bn
甪	lu	py
蕗	lu	ck
舻	lu	vu
栌	lu	mu
簏	lu	vl
菉	lu	cu
氇	lu	mo
僇	lu	rp
琭	lu	wu
镥	lu	jo
勠	lu	xl
稑	lu	ht
绿	lu	su
澛	lu	do
𫘧	lu	mu
𬬻	lu	ju
乱	lr	uv
卵	lr	pd
鸾	lr	wn
峦	lr	wu
挛	lr	wu
銮	lr	wj
孪	lr	wz
栾	lr	wm
滦	lr	dm
脔	lr	wr
娈	lr	wn
论	ly	yl
伦	ly	rl
轮	ly	il
仑	ly	rb
沦	ly	dl
抡	ly	fl
囵	ly	kl
𫭢	ly	tl
𬬭	ly	jl
罗	lo	sx
洛	lo	dk
裸	lo	pg
逻	lo	zx
骆	lo	mk
萝	lo	cx
螺	lo	ix
锣	lo	jx
啰	lo	kx
珞	lo	wk
骡	lo	mx
摞	lo	fx
雒	lo	wv
荦	lo	cn
箩	lo	vx
椤	lo	mx
猡	lo	qx
蠃	lo	wi
脶	lo	on
漯	lo	dx
倮	lo	rg
捋	lo	fc
瘰	lo	bx
泺	lo	dl
蓏	lo	cg
律	lv	ry
率	lv	wu
旅	lv	fy
吕	lv	kk
缕	lv	sn
侣	lv	rk
驴	lv	mh
屡	lv	un
履	lv	uw
滤	lv	dx
虑	lv	hx
褛	lv	pn
铝	lv	jk
闾	lv	mk
榈	lv	mk
氯	lv	qu
膂	lv	fo
稆	lv	hk
葎	lv	cy
垏	lv	ty
梠	lv	mk
略	lt	tk
掠	lt	fx
锊	lt	jc
䂮	lt	fu
圙	lt	km
吗	ma	km
马	ma	va
妈	ma	nm
麻	ma	gm
嘛	ma	km
骂	ma	km
码	ma	um
玛	ma	wm
抹	ma	fw
蚂	ma	im
蟆	ma	id
犸	ma	qm
杩	ma	mm
祃	ma	pm
摩	ma	gu
买	md	ad
卖	md	ud
埋	md	tl
脉	md	oy
麦	md	fw
迈	md	zw
霾	md	yl
劢	md	wl
唛	md	kw
荬	md	cd
鿏	md	jw
满	mj	dl
慢	mj	xy
漫	mj	dy
曼	mj	oy
蛮	mj	wi
瞒	mj	ol
蔓	mj	cy
馒	mj	uy
幔	mj	jy
谩	mj	yy
鳗	mj	yy
缦	mj	sy
嫚	mj	ny
墁	mj	ty
颟	mj	cy
螨	mj	il
鞔	mj	ge
镘	mj	jy
鬘	mj	ey
𬜬	mj	ck
忙	mh	xw
芒	mh	cw
茫	mh	cw
氓	mh	wm
莽	mh	cc
盲	mh	wo
蟒	mh	ic
邙	mh	we
漭	mh	dc
牤	mh	nw
硭	mh	uw
尨	mh	lp
牻	mh	np
厖	mh	ip
杧	mh	mw
毛	mc	pv
冒	mc	oo
貌	mc	ve
猫	mc	qt
矛	mc	yp
帽	mc	jo
贸	mc	pb
茂	mc	cw
茅	mc	cm
冇	mc	uk
髦	mc	em
卯	mc	pe
锚	mc	jt
袤	mc	ym
瑁	mc	wo
懋	mc	mx
牦	mc	nm
铆	mc	je
昴	mc	oe
耄	mc	lm
蟊	mc	mi
峁	mc	ue
旄	mc	fm
楙	mc	mm
泖	mc	de
瞀	mc	mo
茆	mc	ce
蝥	mc	mi
芼	mc	cm
眊	mc	om
鄚	mc	ce
么	me	ps
没	mw	du
美	mw	yd
每	mw	pm
妹	mw	nw
眉	mw	uo
梅	mw	mm
媚	mw	no
魅	mw	gw
玫	mw	ww
枚	mw	mw
媒	mw	nm
霉	mw	ym
昧	mw	ow
煤	mw	hm
寐	mw	bw
嵋	mw	uo
莓	mw	cm
湄	mw	do
袂	mw	pg
楣	mw	mo
酶	mw	ym
镁	mw	jd
郿	mw	ue
浼	mw	de
鹛	mw	un
镅	mw	jo
渼	mw	dd
糜	mw	gm
媄	mw	nd
瑂	mw	wo
们	mf	rm
门	mf	dv
闷	mf	mx
懑	mf	dx
扪	mf	fm
焖	mf	hx
钔	mf	jm
呇	mf	uk
𫞩	mf	wl
梦	mg	mx
猛	mg	qm
蒙	mg	cu
孟	mg	zm
盟	mg	om
朦	mg	ou
萌	mg	co
懵	mg	xo
檬	mg	mu
蜢	mg	im
勐	mg	zl
虻	mg	iw
艨	mg	vu
锰	mg	jm
幪	mg	ju
艋	mg	vm
蠓	mg	iu
瞢	mg	co
甍	mg	cw
獴	mg	qu
礞	mg	uu
㠓	mg	uu
鹲	mg	cn
𫑡	mg	ke
米	mi	bm
密	mi	bu
迷	mi	zm
弥	mi	gx
蜜	mi	bi
眯	mi	om
咪	mi	km
谜	mi	ym
觅	mi	vj
靡	mi	gf
谧	mi	ym
祢	mi	px
芈	mi	cf
麋	mi	lm
弭	mi	ge
汨	mi	do
猕	mi	qx
幂	mi	bj
縻	mi	gx
蘼	mi	cf
醚	mi	ym
祕	mi	pb
敉	mi	mw
嘧	mi	ku
蓂	mi	cl
脒	mi	om
洣	mi	dm
醾	mi	ym
面	mm	ao
免	mm	de
勉	mm	dl
绵	mm	sj
眠	mm	om
棉	mm	mj
缅	mm	sm
冕	mm	oe
腼	mm	om
娩	mm	ne
湎	mm	dm
沔	mm	dg
渑	mm	dd
眄	mm	og
丏	mm	gl
勔	mm	ml
愐	mm	xm
偭	mm	rm
𩾃	mm	ye
妙	mn	nu
秒	mn	hu
描	mn	ft
苗	mn	ct
庙	mn	gy
渺	mn	du
瞄	mn	ot
淼	mn	uu
喵	mn	kt
缈	mn	su
藐	mn	ce
邈	mn	ze
眇	mn	ou
杪	mn	mu
鹋	mn	cn
缪	mn	sp
灭	mp	ah
蔑	mp	cd
乜	mp	vv
咩	mp	ky
篾	mp	vd
民	mb	vv
敏	mb	pw
抿	mb	fm
悯	mb	xw
闵	mb	mw
珉	mb	wm
泯	mb	dm
闽	mb	mi
皿	mb	ka
岷	mb	um
旻	mb	ow
缗	mb	so
愍	mb	mx
湣	mb	do
黾	mb	kd
忞	mb	wx
鳘	mb	py
苠	mb	cm
名	mk	xk
明	mk	oo
命	mk	re
鸣	mk	kn
冥	mk	bl
铭	mk	jk
茗	mk	ck
瞑	mk	ol
溟	mk	dl
酩	mk	yk
暝	mk	ol
螟	mk	il
洺	mk	dk
谬	mq	yp
魔	mo	gg
莫	mo	cd
默	mo	lq
模	mo	md
摸	mo	fd
磨	mo	gu
末	mo	am
漠	mo	dd
墨	mo	lt
麽	mo	gm
陌	mo	eb
寞	mo	bd
蓦	mo	cm
沫	mo	dw
膜	mo	od
茉	mo	cw
嬷	mo	nm
蘑	mo	cu
摹	mo	cu
馍	mo	ud
谟	mo	yd
嫫	mo	nd
秣	mo	hw
殁	mo	du
貊	mo	vb
靺	mo	gw
貘	mo	vd
镆	mo	jd
瘼	mo	bd
耱	mo	lu
万	mo	av
无	mo	ay
藦	mo	cu
𬙊	mo	st
某	mz	gm
谋	mz	ym
眸	mz	on
牟	mz	sn
哞	mz	kn
鍪	mz	mj
侔	mz	rn
蛑	mz	in
目	mu	ke
母	mu	md
木	mu	ur
慕	mu	cx
幕	mu	cj
姆	mu	nm
穆	mu	hp
牧	mu	nw
墓	mu	ct
沐	mu	dm
暮	mu	co
拇	mu	fm
牡	mu	nt
亩	mu	wt
募	mu	cl
睦	mu	ot
苜	mu	co
呒	mu	kw
钼	mu	jo
毪	mu	mn
仫	mu	rm
𧿹	mu	zm
𬭁	mu	jm
那	na	ve
哪	na	ke
拿	na	ru
娜	na	ne
纳	na	sn
呐	na	kn
捺	na	fu
衲	na	pn
钠	na	jn
肭	na	on
镎	na	ju
乸	na	ym
南	na	ug
𦰡	na	ce
奶	nd	nn
奈	nd	du
耐	nd	ec
乃	nd	pv
鼐	nd	no
氖	nd	qn
萘	nd	cu
艿	nd	cn
柰	nd	mu
佴	nd	re
迺	nd	zx
难	nj	yv
男	nj	tl
喃	nj	kg
楠	nj	mg
囡	nj	kn
赧	nj	iy
腩	nj	og
蝻	nj	ig
萳	nj	cg
婻	nj	ng
囊	nh	gy
囔	nh	ky
馕	nh	uy
攮	nh	fy
曩	nh	of
齉	nh	zy
脑	nc	ox
闹	nc	mj
恼	nc	xx
挠	nc	fw
瑙	nc	wx
孬	nc	bz
呶	nc	ky
淖	nc	du
猱	nc	qm
铙	nc	jw
垴	nc	tx
蛲	nc	iw
硇	nc	ux
臑	nc	oe
峱	nc	qu
呢	ne	kb
讷	ne	yn
内	nw	kr
馁	nw	un
嫩	nf	nw
恁	nf	rx
能	ng	sb
你	ni	rx
尼	ni	ub
妮	ni	nb
泥	ni	db
逆	ni	zn
拟	ni	fr
腻	ni	ob
倪	ni	re
霓	ni	ye
匿	ni	kk
溺	ni	dg
昵	ni	ob
睨	ni	oe
旎	ni	fb
怩	ni	xb
猊	ni	qe
鲵	ni	ye
伲	ni	rb
坭	ni	tb
铌	ni	jb
麑	ni	le
薿	ni	cz
𨺙	ni	ee
𫐐	ni	ie
𫠜	ni	ve
年	nm	pf
念	nm	rx
黏	nm	hv
拈	nm	fv
捻	nm	fx
碾	nm	uy
撵	nm	fi
蔫	nm	ch
廿	nm	ca
辇	nm	fi
鲇	nm	yv
鲶	nm	yx
埝	nm	tx
粘	nm	mv
娘	nl	nl
酿	nl	yl
鸟	nn	na
尿	nn	uu
袅	nn	ny
茑	nn	cn
脲	nn	ou
捏	np	ft
聂	np	ey
孽	np	cz
涅	np	dt
蹑	np	zy
嗫	np	ky
啮	np	kr
臬	np	zm
镊	np	jy
镍	np	jm
蘖	np	cm
颞	np	ey
糵	np	cm
陧	np	et
嵲	np	um
菍	np	cx
𫔶	np	mm
您	nb	rx
宁	nk	bd
凝	nk	dz
狞	nk	qd
拧	nk	fd
柠	nk	md
咛	nk	kd
泞	nk	dd
佞	nk	rn
甯	nk	by
苧	nk	cd
聍	nk	ed
牛	nq	pu
扭	nq	fi
纽	nq	si
妞	nq	ni
钮	nq	ji
忸	nq	xi
狃	nq	qi
农	ns	by
浓	ns	dy
哝	ns	ky
侬	ns	ry
脓	ns	oy
秾	ns	hy
𬪩	ns	yy
耨	nz	lc
怒	nu	nx
努	nu	nl
奴	nu	ny
弩	nu	ng
驽	nu	nm
孥	nu	nz
傉	nu	rc
胬	nu	nr
砮	nu	nu
笯	nu	vy
暖	nr	oy
诺	no	yk
挪	no	fe
懦	no	xe
喏	no	kk
糯	no	me
傩	no	rv
搦	no	fg
锘	no	jk
女	nv	va
钕	nv	jn
恧	nv	ex
衄	nv	pi
虐	nt	he
疟	nt	be
噢	oo	kd
喔	oo	kt
欧	ou	qq
偶	ou	rd
呕	ou	kq
殴	ou	qu
鸥	ou	qn
藕	ou	cd
区	ou	kx
怄	ou	xq
瓯	ou	qw
讴	ou	yq
沤	ou	dq
耦	ou	ld
𠙶	ou	kl
𬉼	ou	hq
怕	pa	xb
爬	pa	vb
帕	pa	jb
啪	pa	kb
趴	pa	zb
琶	pa	wb
葩	pa	cb
杷	pa	mb
筢	pa	vb
舥	pa	vb
潖	pa	db
派	pd	dy
排	pd	ff
拍	pd	fb
牌	pd	pu
徘	pd	rf
湃	pd	df
俳	pd	rf
哌	pd	ky
簰	pd	vu
蒎	pd	cy
迫	pd	zb
盘	pj	vm
判	pj	bd
叛	pj	by
盼	pj	of
潘	pj	dt
攀	pj	mu
畔	pj	tb
蹒	pj	zl
磐	pj	vu
蟠	pj	it
槃	pj	vm
爿	pj	vl
泮	pj	db
袢	pj	pb
磻	pj	ut
襻	pj	pu
胖	pj	ob
旁	ph	wf
庞	ph	gl
彷	ph	rf
乓	ph	qd
螃	ph	if
滂	ph	df
逄	ph	zf
雱	ph	yf
耪	ph	lf
鳑	ph	yf
跑	pc	zb
泡	pc	db
抛	pc	fl
袍	pc	pb
咆	pc	kb
庖	pc	gb
狍	pc	qb
疱	pc	bb
匏	pc	db
脬	pc	oz
陪	pw	ek
配	pw	yj
佩	pw	rj
培	pw	tk
赔	pw	bk
裴	pw	fy
沛	pw	dj
呸	pw	kp
胚	pw	op
帔	pw	jp
辔	pw	sk
霈	pw	yj
旆	pw	fj
醅	pw	yk
锫	pw	jk
衃	pw	pb
喷	pf	kb
盆	pf	fm
湓	pf	dm
碰	pg	uy
朋	pg	oo
鹏	pg	on
捧	pg	ff
砰	pg	up
蓬	pg	cf
篷	pg	vf
彭	pg	tp
棚	pg	mo
膨	pg	op
澎	pg	dp
怦	pg	xp
嘭	pg	kp
烹	pg	wh
抨	pg	fp
芃	pg	cf
硼	pg	uo
蟛	pg	ip
堋	pg	to
椪	pg	my
弸	pg	go
淜	pg	do
皮	pi	py
批	pi	fb
屁	pi	ub
疲	pi	bp
匹	pi	ke
劈	pi	ud
披	pi	fp
脾	pi	ou
啤	pi	ku
僻	pi	rx
霹	pi	yx
痞	pi	bk
譬	pi	uk
噼	pi	kx
琵	pi	wb
癖	pi	bx
媲	pi	nb
丕	pi	ba
毗	pi	tb
坯	pi	tp
纰	pi	sb
睥	pi	ou
邳	pi	be
砒	pi	ub
貔	pi	vb
枇	pi	mb
罴	pi	sh
圮	pi	tj
鼙	pi	tu
蚍	pi	ib
铍	pi	jp
郫	pi	pe
仳	pi	rb
伾	pi	rp
蜱	pi	iu
埤	pi	tu
嚭	pi	tk
陴	pi	eu
淠	pi	dw
甓	pi	uw
狉	pi	qp
澼	pi	dx
鲏	pi	yp
䴙	pi	un
苉	pi	cp
𬳵	pi	mp
片	pm	pv
偏	pm	rc
骗	pm	mc
篇	pm	vc
翩	pm	hx
骈	pm	mk
蹁	pm	zc
谝	pm	yc
胼	pm	ok
犏	pm	nc
楩	pm	mg
㛹	pm	ng
𡎚	pm	tc
飘	pn	xf
漂	pn	du
票	pn	xu
瞟	pn	ou
嫖	pn	nu
瓢	pn	xg
缥	pn	su
剽	pn	xd
朴	pn	mb
殍	pn	dz
嘌	pn	ku
螵	pn	iu
蔈	pn	cu
薸	pn	cu
撇	pp	fw
瞥	pp	xo
苤	pp	cp
氕	pp	qp
𬭯	pp	jw
品	pb	kk
拼	pb	fk
贫	pb	fb
频	pb	vy
聘	pb	ek
嫔	pb	nb
颦	pb	vu
姘	pb	nk
牝	pb	nb
玭	pb	wb
𬞟	pb	cy
平	pk	au
凭	pk	rj
评	pk	yp
瓶	pk	bw
萍	pk	cp
苹	pk	cp
坪	pk	tp
乒	pk	qp
娉	pk	nk
枰	pk	mp
鲆	pk	yp
俜	pk	rk
泙	pk	dp
洴	pk	dk
帡	pk	jk
荓	pk	ck
蚲	pk	ip
涄	pk	dk
玶	pk	wp
破	po	up
婆	po	dn
颇	po	py
坡	po	tp
魄	po	bg
泼	po	dy
珀	po	wb
叵	po	kk
鄱	po	ce
粕	po	mb
笸	po	vk
皤	po	bt
钋	po	jb
钷	po	jk
桲	po	mz
䥽	po	jy
酦	po	yy
剖	pz	ld
抔	pz	fb
裒	pz	yj
掊	pz	fk
普	pu	bo
扑	pu	fb
铺	pu	jf
仆	pu	rb
谱	pu	yo
葡	pu	cf
菩	pu	ck
噗	pu	kf
浦	pu	df
蒲	pu	cf
濮	pu	df
璞	pu	wf
圃	pu	kf
溥	pu	dc
匍	pu	bf
莆	pu	cf
蹼	pu	zf
氆	pu	mo
潽	pu	do
酺	pu	yf
镨	pu	jo
镤	pu	jf
蒱	pu	cf
墣	pu	tf
穙	pu	hf
起	qi	tj
气	qi	pv
其	qi	cb
七	qi	av
器	qi	kk
骑	qi	mk
齐	qi	wl
弃	qi	wc
妻	qi	un
企	qi	rv
启	qi	hk
旗	qi	fb
欺	qi	cq
岂	qi	uj
汽	qi	dq
棋	qi	mb
琪	qi	wb
泣	qi	dl
凄	qi	dn
漆	qi	du
戚	qi	wx
契	qi	fd
乞	qi	pv
祈	qi	pj
麒	qi	lb
歧	qi	vv
琦	qi	wk
祁	qi	pe
绮	qi	sk
栖	qi	mx
炁	qi	wh
淇	qi	db
崎	qi	uk
砌	qi	ud
蹊	qi	zd
祺	qi	pb
迄	qi	zv
杞	qi	mj
岐	qi	uv
脐	qi	oq
颀	qi	jy
沏	qi	dd
跂	qi	zv
憩	qi	ux
萋	qi	cn
嘁	qi	kx
耆	qi	lo
芑	qi	cj
蜞	qi	ib
讫	qi	yv
祇	qi	pu
鳍	qi	yo
亓	qi	aw
葺	qi	ce
柒	qi	dm
綦	qi	cx
蕲	qi	cj
畦	qi	tt
芪	qi	cu
圻	qi	tj
萁	qi	cb
骐	qi	mb
欹	qi	dq
碛	qi	ub
汔	qi	dv
锜	qi	jk
槭	qi	mx
蛴	qi	iq
屺	qi	uj
玘	qi	wj
桤	qi	mj
埼	qi	tk
棨	qi	hm
郪	qi	ue
磜	qi	uu
鲯	qi	yb
愭	qi	xo
碶	qi	ud
俟	qi	ru
婍	qi	nk
洓	qi	du
䓫	qi	ck
𨙸	qi	ve
𬨂	qi	iu
恰	qx	xk
掐	qx	fj
洽	qx	dk
拤	qx	fb
葜	qx	cd
袷	qx	pk
髂	qx	gk
前	qm	bd
钱	qm	jj
千	qm	pu
潜	qm	do
牵	qm	dn
倩	qm	ro
浅	qm	dj
签	qm	vq
歉	qm	jq
欠	qm	dr
乾	qm	uv
谦	qm	yj
迁	qm	zq
遣	qm	zl
茜	qm	cx
芊	qm	cq
嵌	qm	uq
虔	qm	hw
铅	qm	jk
谴	qm	yl
钳	qm	jg
黔	qm	lv
堑	qm	it
骞	qm	bm
佥	qm	ra
仟	qm	rq
缱	qm	sl
纤	qm	sq
阡	qm	eq
钎	qm	jq
钤	qm	jv
掮	qm	fo
芡	qm	cq
荨	qm	cc
扦	qm	fq
愆	qm	rx
悭	qm	xt
搴	qm	bu
慊	qm	xj
褰	qm	by
汧	qm	dk
肷	qm	oq
蒨	qm	co
靬	qm	gg
椠	qm	im
杄	qm	mq
鹐	qm	dn
岍	qm	uk
圲	qm	tq
伣	qm	rj
墘	qm	tv
磏	qm	uj
𬘬	qm	so
枪	ql	mv
墙	ql	tk
抢	ql	fv
腔	ql	og
呛	ql	kv
跄	ql	zv
蔷	ql	ck
锵	ql	jc
羌	ql	yv
戕	ql	pg
戗	ql	rg
襁	ql	pi
嫱	ql	nk
樯	ql	mk
镪	ql	ji
炝	ql	hv
羟	ql	yj
蜣	ql	iv
玱	ql	wv
锖	ql	jo
蔃	ql	ci
巧	qn	gk
悄	qn	xo
瞧	qn	oh
敲	qn	wy
桥	qn	ml
乔	qn	yl
俏	qn	ro
翘	qn	yx
窍	qn	bk
鞘	qn	go
憔	qn	xh
峭	qn	uo
跷	qn	zw
侨	qn	rl
樵	qn	mh
撬	qn	fm
锹	qn	jh
谯	qn	yh
橇	qn	mm
诮	qn	yo
荞	qn	cl
愀	qn	xh
劁	qn	rd
硗	qn	uw
鞒	qn	gl
硚	qn	ul
缲	qn	sm
雀	qn	xv
且	qp	oa
切	qp	qd
窃	qp	bd
怯	qp	xq
妾	qp	ln
惬	qp	xj
锲	qp	jd
挈	qp	fu
箧	qp	vj
郄	qp	xe
亲	qb	lm
秦	qb	ih
琴	qb	wv
侵	qb	ry
勤	qb	cl
寝	qb	by
擒	qb	fn
钦	qb	jq
芹	qb	cj
沁	qb	dx
禽	qb	rn
覃	qb	xu
噙	qb	kn
衾	qb	ry
揿	qb	fq
芩	qb	cv
溱	qb	dh
吣	qb	kx
嗪	qb	kh
锓	qb	jy
檎	qb	mn
骎	qb	my
慬	qb	xw
嵚	qb	uq
请	qk	yo
轻	qk	ij
清	qk	do
青	qk	fo
情	qk	xo
庆	qk	gd
晴	qk	oo
倾	qk	ry
卿	qk	pg
擎	qk	cu
顷	qk	by
蜻	qk	io
箐	qk	vo
氢	qk	qj
罄	qk	tf
磬	qk	tu
綮	qk	hx
氰	qk	qo
黥	qk	lx
檠	qk	cm
鲭	qk	yo
苘	qk	ck
圊	qk	ko
碃	qk	uo
庼	qk	gy
勍	qk	wl
穷	qs	bl
琼	qs	wx
穹	qs	bg
茕	qs	cu
邛	qs	ge
筇	qs	ve
蛩	qs	gi
銎	qs	gj
䓖	qs	cl
求	qq	au
球	qq	wq
秋	qq	hh
丘	qq	ja
邱	qq	qe
囚	qq	kr
裘	qq	qy
酋	qq	by
虬	qq	iv
糗	qq	mq
鳅	qq	yh
蚯	qq	iq
俅	qq	rq
泅	qq	dr
遒	qq	zy
逑	qq	zq
楸	qq	mh
犰	qq	qj
萩	qq	ch
蝤	qq	iy
璆	qq	wp
巯	qq	ji
赇	qq	bq
鹙	qq	hn
鞧	qq	gy
鼽	qq	zj
訄	qq	jk
𨱇	qq	jq
去	qu	ts
取	qu	ey
趣	qu	ty
曲	qu	kc
屈	qu	ui
躯	qu	uq
驱	qu	mq
娶	qu	en
趋	qu	te
渠	qu	dm
觑	qu	hj
瞿	qu	ov
岖	qu	uq
蛐	qu	iq
蛆	qu	iq
衢	qu	rv
祛	qu	pq
黢	qu	lw
癯	qu	bv
阒	qu	mq
龋	qu	vy
蕖	qu	cm
蘧	qu	cu
朐	qu	oj
璩	qu	wu
劬	qu	jl
磲	qu	um
诎	qu	yi
蠼	qu	iy
袪	qu	pq
氍	qu	om
鸲	qu	jn
麹	qu	fm
胠	qu	oq
灈	qu	dv
鼩	qu	jj
竘	qu	lj
戌	qu	wa
㭕	qu	mq
䓛	qu	ci
坥	qu	tq
𪨰	qu	uq
𫭟	qu	tq
全	qr	rw
权	qr	my
拳	qr	ju
劝	qr	yl
泉	qr	bu
犬	qr	dd
券	qr	jd
蜷	qr	iv
痊	qr	bw
诠	qr	yw
荃	qr	cw
颧	qr	cy
绻	qr	sv
铨	qr	jw
筌	qr	vw
鬈	qr	ev
醛	qr	yw
悛	qr	xw
佺	qr	rw
畎	qr	tq
棬	qr	mv
鳈	qr	yu
辁	qr	iw
婘	qr	nv
瑔	qr	wu
𨟠	qr	oe
却	qt	qe
确	qt	uy
缺	qt	fg
瘸	qt	br
鹊	qt	cn
阙	qt	mq
阕	qt	mt
榷	qt	mv
炔	qt	hg
悫	qt	tx
碏	qt	uo
埆	qt	ty
𬒈	qt	xu
群	qy	yy
裙	qy	pk
逡	qy	zw
囷	qy	kh
然	rj	xh
染	rj	dm
燃	rj	hh
冉	rj	kt
髯	rj	er
苒	rj	cr
蚺	rj	ir
䎃	rj	rx
让	rh	yu
嚷	rh	kf
壤	rh	tf
攘	rh	ff
瓤	rh	yg
禳	rh	pf
穰	rh	hf
瀼	rh	df
蘘	rh	cf
儴	rh	rf
绕	rc	sw
扰	rc	fy
饶	rc	uw
娆	rc	nw
桡	rc	mw
荛	rc	cw
热	re	fh
惹	re	cx
人	rf	pn
任	rf	rw
认	rf	yr
忍	rf	rx
仁	rf	re
刃	rf	dd
韧	rf	wr
壬	rf	pt
饪	rf	uw
仞	rf	rr
纫	rf	sr
稔	rf	hx
荏	rf	cw
妊	rf	nw
衽	rf	pw
轫	rf	ir
纴	rf	sw
讱	rf	yr
葚	rf	cb
仍	rg	rn
扔	rg	fn
日	ri	ka
驲	ri	mo
容	rs	bg
荣	rs	cm
融	rs	gi
蓉	rs	cg
绒	rs	su
溶	rs	dg
戎	rs	gu
榕	rs	mg
茸	rs	ce
熔	rs	hg
冗	rs	bj
嵘	rs	um
镕	rs	jg
蝾	rs	im
狨	rs	qu
瑢	rs	wg
肉	rz	nr
柔	rz	mm
揉	rz	fm
蹂	rz	zm
糅	rz	mm
鞣	rz	gm
𫐓	rz	im
如	ru	nk
入	ru	pn
辱	ru	ic
乳	ru	vv
儒	ru	re
茹	ru	ck
汝	ru	dn
蠕	ru	ie
孺	ru	ze
褥	ru	pc
嚅	ru	ke
濡	ru	de
缛	ru	sc
襦	ru	pe
溽	ru	dc
蓐	ru	cc
洳	ru	dk
薷	ru	ce
颥	ru	yy
嬬	ru	ne
铷	ru	jk
软	rr	iq
阮	rr	ey
堧	rr	td
瓀	rr	we
媆	rr	nd
瑞	rv	we
锐	rv	jx
蕊	rv	cx
睿	rv	bo
芮	rv	cn
蚋	rv	in
蕤	rv	cu
枘	rv	mn
汭	rv	dn
润	ry	dw
闰	ry	mw
若	ro	ck
弱	ro	gg
偌	ro	rk
箬	ro	vk
婼	ro	nk
爇	ro	ch
蒻	ro	cg
鄀	ro	ce
撒	sa	fw
洒	sa	dx
飒	sa	lf
仨	sa	rs
萨	sa	ci
卅	sa	ai
靸	sa	gj
挲	sa	du
潵	sa	dw
脎	sa	om
赛	sd	bb
塞	sd	bt
腮	sd	ox
噻	sd	kt
鳃	sd	yx
三	sj	ae
散	sj	cw
伞	sj	ru
叁	sj	ss
馓	sj	uw
毵	sj	sm
糁	sj	mp
丧	sh	ty
桑	sh	ym
嗓	sh	km
搡	sh	fm
颡	sh	yy
磉	sh	um
扫	sc	fe
骚	sc	mi
嫂	sc	ny
搔	sc	fi
臊	sc	om
瘙	sc	bi
缫	sc	sg
埽	sc	tj
溞	sc	di
色	se	db
瑟	se	wb
涩	se	dv
啬	se	tk
穑	se	hk
铯	se	jb
璱	se	wb
森	sf	mm
僧	sg	ro
啥	ua	kg
傻	ua	rw
杀	ua	xm
莎	ua	cu
沙	ua	du
纱	ua	su
煞	ua	dh
厦	ua	iw
霎	ua	yn
砂	ua	uu
鲨	ua	dy
裟	ua	dy
铩	ua	jm
嗄	ua	kw
歃	ua	qq
痧	ua	bu
唼	ua	kn
杉	ua	mp
晒	ud	ox
筛	ud	vj
山	uj	kl
删	uj	cd
闪	uj	mr
善	uj	yk
扇	uj	hx
衫	uj	pp
珊	uj	wc
擅	uj	fd
姗	uj	nc
讪	uj	yu
陕	uj	ej
煽	uj	hx
膳	uj	ok
跚	uj	zc
潸	uj	do
缮	uj	sk
汕	uj	du
赡	uj	bk
鳝	uj	yk
舢	uj	vu
苫	uj	cv
嬗	uj	nd
鄯	uj	ye
骟	uj	mx
蟮	uj	ik
墡	uj	tk
剡	uj	hd
疝	uj	bu
芟	uj	cu
埏	uj	tv
钐	uj	jp
嶦	uj	uk
晱	uj	oh
栅	uj	mc
烻	uj	hv
𫮃	uj	tu
上	uh	ba
伤	uh	rl
商	uh	wk
尚	uh	xk
赏	uh	xb
晌	uh	ok
殇	uh	dp
觞	uh	dp
熵	uh	hk
墒	uh	tk
绱	uh	sk
垧	uh	tk
少	uc	xp
烧	uc	hw
稍	uc	ho
绍	uc	sk
哨	uc	ko
邵	uc	de
勺	uc	bd
梢	uc	mo
韶	uc	lk
劭	uc	dl
捎	uc	fo
芍	uc	cu
苕	uc	ck
艄	uc	vo
筲	uc	vo
潲	uc	do
蛸	uc	io
睄	uc	oo
召	uc	dk
柖	uc	mk
玿	uc	wk
射	ue	uc
设	ue	yu
舍	ue	rg
蛇	ue	ib
舌	ue	qk
涉	ue	du
摄	ue	fy
社	ue	pt
奢	ue	do
慑	ue	xy
赦	ue	iw
折	ue	fj
佘	ue	ru
麝	ue	lc
赊	ue	bu
畲	ue	rt
猞	ue	qg
歙	ue	rq
滠	ue	dy
厍	ue	ii
拾	ue	fk
𪨶	ue	ui
谁	uw	yv
神	uf	pu
深	uf	dm
身	uf	zc
甚	uf	cb
伸	uf	ru
什	uf	ru
沈	uf	de
审	uf	bu
申	uf	ol
慎	uf	xb
呻	uf	ku
渗	uf	dp
婶	uf	nu
绅	uf	su
肾	uf	lo
莘	uf	cx
珅	uf	wu
蜃	uf	ii
哂	uf	kx
娠	uf	ni
燊	uf	hm
瘆	uf	bp
椹	uf	mb
砷	uf	uu
诜	uf	ye
甡	uf	uu
谂	uf	yx
矧	uf	ul
胂	uf	ou
侁	uf	re
瞫	uf	ou
鲹	uf	yp
屾	uf	uu
𬬹	uf	ju
𬳽	uf	me
生	ug	pf
声	ug	tu
圣	ug	yt
胜	ug	ou
升	ug	pc
省	ug	uo
剩	ug	qd
绳	ug	sd
牲	ug	nu
笙	ug	vu
甥	ug	ul
昇	ug	oc
嵊	ug	ur
眚	ug	uo
陞	ug	et
是	ui	oz
时	ui	oc
事	ui	gy
实	ui	bd
十	ui	al
师	ui	lj
使	ui	rl
屎	ui	um
世	ui	cv
始	ui	nk
失	ui	pf
士	ui	ua
湿	ui	dy
识	ui	yv
视	ui	pj
势	ui	fl
市	ui	wj
室	ui	bt
式	ui	yg
示	ui	ex
试	ui	yg
史	ui	kn
食	ui	rg
施	ui	fy
适	ui	zu
释	ui	cf
诗	ui	yc
尸	ui	kp
氏	ui	pv
侍	ui	rc
饰	ui	uj
誓	ui	fk
驶	ui	mu
逝	ui	zj
狮	ui	qj
噬	ui	kr
仕	ui	rt
矢	ui	pd
拭	ui	fg
嗜	ui	ko
似	ui	rr
蚀	ui	ui
恃	ui	xc
柿	ui	mj
弑	ui	xg
轼	ui	ig
虱	ui	vi
谥	ui	ym
舐	ui	uu
媞	ui	nz
豕	ui	au
莳	ui	cc
筮	ui	vr
蓍	ui	co
螫	ui	ii
炻	ui	hu
鲥	ui	yc
奭	ui	db
湜	ui	dz
埘	ui	tc
酾	ui	yd
祏	ui	pu
栻	ui	mg
贳	ui	ub
铈	ui	jj
鲺	ui	yi
鼫	ui	ju
邿	ui	te
鸤	ui	un
嘘	ui	ky
峙	ui	uc
殖	ui	dq
浉	ui	dj
襫	ui	pb
䏡	ui	ou
䴓	ui	bn
𫚕	ui	yj
𬤊	ui	yz
手	uz	pf
受	uz	vy
收	uz	jw
首	uz	bz
守	uz	bc
熟	uz	wh
兽	uz	bk
授	uz	fy
瘦	uz	by
售	uz	rk
寿	uz	fc
狩	uz	qc
绶	uz	sy
艏	uz	vz
书	uu	vd
数	uu	mw
树	uu	mc
术	uu	md
属	uu	uy
叔	uu	uy
束	uu	gr
舒	uu	ry
输	uu	id
述	uu	zu
殊	uu	dw
鼠	uu	jv
疏	uu	vi
淑	uu	dy
竖	uu	ll
署	uu	so
墅	uu	lt
梳	uu	mi
蜀	uu	si
恕	uu	nx
倏	uu	rq
暑	uu	oo
庶	uu	gh
漱	uu	dq
赎	uu	bd
姝	uu	nw
枢	uu	mq
蔬	uu	ci
薯	uu	co
曙	uu	oo
抒	uu	fy
孰	uu	ww
戍	uu	wd
塾	uu	wt
纾	uu	sy
澍	uu	dc
黍	uu	hu
沭	uu	du
秫	uu	hu
殳	uu	jy
菽	uu	cy
腧	uu	od
毹	uu	rm
摅	uu	fx
婌	uu	ny
鄃	uu	re
隃	uu	ed
陎	uu	ew
𬬸	uu	ju
刷	ux	ud
耍	ux	en
唰	ux	kd
帅	uk	lj
摔	uk	fu
甩	uk	yv
衰	uk	yv
蟀	uk	iu
栓	ur	mw
拴	ur	fw
涮	ur	dd
闩	ur	ma
腨	ur	oe
双	ul	yy
爽	ul	dx
霜	ul	yo
孀	ul	no
鹴	ul	yn
骦	ul	mo
礵	ul	uo
水	uv	ln
睡	uv	ot
税	uv	hx
帨	uv	jx
说	uv	yx
顺	uy	iy
瞬	uy	of
吮	uy	ky
舜	uy	vf
楯	uy	mo
烁	uo	hl
硕	uo	uy
朔	uo	no
铄	uo	jl
槊	uo	nm
搠	uo	fo
妁	uo	nu
蒴	uo	co
死	si	db
四	si	ke
思	si	tx
斯	si	cj
司	si	vk
丝	si	sa
私	si	hs
寺	si	tc
撕	si	fj
肆	si	ey
嘶	si	kj
厮	si	ij
祀	si	ps
嗣	si	kk
饲	si	uk
巳	si	kv
泗	si	ds
咝	si	ks
姒	si	nr
汜	si	ds
驷	si	ms
鸶	si	sn
兕	si	ae
涘	si	du
缌	si	sx
蛳	si	ij
澌	si	dj
锶	si	jx
笥	si	vk
耜	si	ll
飔	si	fx
凘	si	dj
虒	si	ij
㟃	si	uk
楒	si	mx
送	ss	zt
松	ss	mg
宋	ss	bm
耸	ss	re
诵	ss	yy
怂	ss	rx
𪨊	ss	ur
颂	ss	gy
嵩	ss	uk
悚	ss	xu
讼	ss	yg
忪	ss	xg
淞	ss	dg
崧	ss	ug
竦	ss	lu
凇	ss	dg
菘	ss	cg
娀	ss	nu
㧐	ss	fy
搜	sz	fy
艘	sz	vy
嗽	sz	kq
嗖	sz	ky
叟	sz	jy
飕	sz	fy
擞	sz	fw
馊	sz	uy
薮	sz	cw
廋	sz	gy
溲	sz	dy
嗾	sz	ku
锼	sz	jy
瞍	sz	oy
蒐	sz	cg
螋	sz	iy
诉	su	yi
速	su	zu
苏	su	cb
素	su	fx
宿	su	bb
俗	su	rg
肃	su	yb
塑	su	nt
酥	su	yh
簌	su	vq
粟	su	xm
稣	su	yh
溯	su	do
愫	su	xx
夙	su	jd
谡	su	yw
窣	su	bu
蔌	su	cq
涑	su	du
嗉	su	kx
僳	su	rm
觫	su	du
骕	su	mb
甦	su	gu
鹔	su	yn
傃	su	rx
蹜	su	zb
缩	su	sb
𫗧	su	uu
算	sr	vc
酸	sr	yw
蒜	sr	cu
狻	sr	qw
岁	sv	ux
随	sv	eo
虽	sv	ki
碎	sv	uu
遂	sv	zu
隋	sv	eo
髓	sv	go
祟	sv	iu
穗	sv	hx
邃	sv	zu
隧	sv	eu
绥	sv	sn
燧	sv	hu
睢	sv	ov
眭	sv	ot
荽	sv	cn
谇	sv	yu
濉	sv	dv
穟	sv	hu
璲	sv	wu
襚	sv	pu
旞	sv	fu
𫟦	sv	iu
𬭼	sv	ju
孙	sy	zx
损	sy	fb
笋	sy	vy
隼	sy	ru
荪	sy	cx
狲	sy	qx
榫	sy	mu
飧	sy	xg
所	so	hj
索	so	ux
锁	so	jb
嗦	so	kx
梭	so	mw
琐	so	wb
唆	so	kw
娑	so	dn
蓑	so	cv
桫	so	mu
唢	so	kb
睃	so	ow
嗍	so	ko
羧	so	yw
溹	so	dx
他	ta	ry
她	ta	ny
它	ta	bb
塔	ta	tk
踏	ta	zo
拓	ta	fu
塌	ta	tx
榻	ta	mx
蹋	ta	zx
遢	ta	zx
挞	ta	fd
趿	ta	zj
獭	ta	qb
祂	ta	py
闼	ta	md
鳎	ta	yx
铊	ta	jb
溻	ta	dx
阘	ta	mx
褟	ta	px
鞳	ta	gk
太	td	dd
台	td	sk
态	td	tx
抬	td	fk
泰	td	iu
胎	td	ok
汰	td	dt
苔	td	ck
跆	td	zk
钛	td	jt
邰	td	se
薹	td	ct
肽	td	ot
炱	td	sh
酞	td	yt
鲐	td	yk
谈	tj	yh
叹	tj	ky
探	tj	fm
坦	tj	td
贪	tj	rb
坛	tj	ty
摊	tj	fv
滩	tj	dv
谭	tj	yu
潭	tj	du
瘫	tj	bv
毯	tj	mh
炭	tj	uh
忐	tj	ux
檀	tj	md
痰	tj	bh
碳	tj	uh
袒	tj	pd
昙	tj	oy
坍	tj	td
郯	tj	he
倓	tj	rh
锬	tj	jh
钽	tj	jd
璮	tj	wd
惔	tj	xh
菼	tj	ch
榃	tj	mt
磹	tj	uu
躺	th	uk
汤	th	dp
糖	th	mk
趟	th	tk
烫	th	dh
堂	th	xt
唐	th	gk
膛	th	ot
倘	th	rk
淌	th	dk
棠	th	xm
塘	th	tk
搪	th	fk
螳	th	it
傥	th	rx
瑭	th	wk
镗	th	jt
帑	th	nj
樘	th	mt
蹚	th	zt
嘡	th	kt
溏	th	dk
螗	th	ik
羰	th	yh
镋	th	jx
耥	th	lk
埫	th	tk
铴	th	jp
䣘	th	xe
鄌	th	ge
套	tc	dg
逃	tc	zv
讨	tc	yc
桃	tc	mv
涛	tc	dc
掏	tc	ff
陶	tc	ef
滔	tc	dj
萄	tc	cf
淘	tc	df
韬	tc	wj
焘	tc	fh
啕	tc	kf
饕	tc	kg
绦	tc	sm
洮	tc	dv
梼	tc	mc
绹	tc	sf
弢	tc	gy
鼗	tc	vv
慆	tc	xj
𫘦	tc	mf
特	te	nc
忑	te	xx
慝	te	kx
铽	te	jx
忒	te	yx
疼	tg	bd
腾	tg	om
藤	tg	cu
滕	tg	ou
誊	tg	jk
螣	tg	oi
縢	tg	ox
熥	tg	hy
䲢	tg	oy
题	ti	oy
体	ti	rb
替	ti	fo
踢	ti	zw
梯	ti	md
蹄	ti	zj
惕	ti	xw
涕	ti	dd
啼	ti	kj
剔	ti	od
屉	ti	uu
剃	ti	bd
嚏	ti	kz
倜	ti	rk
缇	ti	sz
逖	ti	zh
荑	ti	cy
醍	ti	yz
悌	ti	xd
鹈	ti	bn
绨	ti	sd
锑	ti	jd
裼	ti	pw
趯	ti	tv
遆	ti	zj
鳀	ti	yz
擿	ti	fg
䏲	ti	od
䴘	ti	in
瑅	ti	wz
𫘨	ti	mz
天	tm	ad
田	tm	ku
甜	tm	ug
添	tm	dx
填	tm	tb
舔	tm	ux
恬	tm	xu
腆	tm	ob
阗	tm	mb
殄	tm	dp
忝	tm	tx
湉	tm	du
畋	tm	tw
觍	tm	qj
瑱	tm	wb
掭	tm	fx
盷	tm	oy
淟	tm	db
晪	tm	ob
沺	tm	dt
黇	tm	cv
条	tn	wm
跳	tn	zv
挑	tn	fv
眺	tn	ov
迢	tn	zk
窕	tn	bv
佻	tn	rv
笤	tn	vk
祧	tn	pv
髫	tn	ek
粜	tn	im
龆	tn	vk
蜩	tn	ik
鲦	tn	ym
朓	tn	ov
嬥	tn	nv
铁	tp	jf
贴	tp	bv
帖	tp	jv
餮	tp	dg
萜	tp	cv
听	tk	kj
停	tk	rd
厅	tk	id
挺	tk	fw
庭	tk	gw
廷	tk	zw
婷	tk	nd
亭	tk	wd
艇	tk	vw
霆	tk	yw
汀	tk	dd
蜓	tk	iw
铤	tk	jw
葶	tk	cd
莛	tk	cw
珽	tk	ww
梃	tk	mw
烃	tk	hj
渟	tk	dd
颋	tk	zy
桯	tk	mw
侹	tk	rw
䗴	tk	iw
圢	tk	td
烶	tk	hw
𬘩	tk	sw
同	ts	kk
通	ts	zy
痛	ts	by
统	ts	sy
童	ts	ll
铜	ts	jk
筒	ts	vk
桶	ts	my
捅	ts	fy
瞳	ts	ol
桐	ts	mk
佟	ts	rd
彤	ts	dp
恸	ts	xl
潼	ts	dl
嗵	ts	ky
僮	ts	rl
酮	ts	yk
仝	ts	rg
茼	ts	ck
曈	ts	ol
砼	ts	ug
烔	ts	hk
橦	ts	ml
哃	ts	kk
穜	ts	hl
鲖	ts	yk
㛚	ts	ny
峂	ts	ud
𦒍	ts	lx
𫍣	ts	yk
头	tz	dd
投	tz	fu
偷	tz	rd
透	tz	zn
骰	tz	gu
突	tu	bq
图	tu	kd
土	tu	ua
徒	tu	rz
吐	tu	kt
途	tu	zm
涂	tu	dm
屠	tu	uo
兔	tu	dd
秃	tu	hj
凸	tu	la
荼	tu	cm
菟	tu	ct
钍	tu	jt
堍	tu	tt
酴	tu	ym
稌	tu	hm
腯	tu	oo
葖	tu	cq
梌	tu	mm
㻬	tu	wk
𬳿	tu	mm
团	tr	kc
湍	tr	de
抟	tr	fv
彖	tr	hu
疃	tr	tl
猯	tr	qe
煓	tr	he
推	tv	fv
退	tv	zg
腿	tv	og
颓	tv	hy
褪	tv	pg
蜕	tv	ix
煺	tv	hg
魋	tv	gv
𬯎	tv	eb
吞	ty	tk
屯	ty	av
臀	ty	uo
豚	ty	ou
饨	ty	ut
暾	ty	ow
鲀	ty	yt
坉	ty	tt
忳	ty	xt
焞	ty	hz
拖	to	fy
脱	to	ox
托	to	fq
妥	to	vn
陀	to	eb
驼	to	mb
唾	to	kt
佗	to	rb
椭	to	mo
坨	to	tb
沱	to	db
砣	to	ub
鸵	to	nb
跎	to	zb
柁	to	mb
酡	to	yb
橐	to	gm
柝	to	mi
侂	to	rq
鼍	to	kd
庹	to	gi
箨	to	vf
萚	to	cf
圫	to	tq
𬶍	to	yb
哇	wa	kt
瓦	wa	ad
娃	wa	nt
挖	wa	fv
袜	wa	pw
蛙	wa	it
娲	wa	nn
洼	wa	dt
佤	wa	rw
窊	wa	bg
腽	wa	om
坬	wa	tg
畖	wa	tg
外	wd	xb
歪	wd	bv
崴	wd	un
完	wj	by
晚	wj	oe
玩	wj	wy
弯	wj	wg
碗	wj	uv
湾	wj	dg
婉	wj	nv
挽	wj	fe
腕	wj	ov
宛	wj	bv
顽	wj	yy
丸	wj	ld
卍	wj	vl
惋	wj	xv
蜿	wj	iv
琬	wj	wv
纨	wj	sw
婠	wj	nl
皖	wj	by
绾	wj	sl
剜	wj	bd
菀	wj	cv
豌	wj	dv
畹	wj	tv
烷	wj	hy
脘	wj	oy
芄	wj	cw
塆	wj	tg
椀	wj	mv
𬇕	wj	dw
王	wh	at
望	wh	ww
往	wh	rv
忘	wh	wx
网	wh	kx
亡	wh	wv
汪	wh	dw
妄	wh	wn
旺	wh	ow
枉	wh	mw
惘	wh	xw
罔	wh	kw
魍	wh	gw
尢	wh	uv
辋	wh	iw
尪	wh	yw
为	ww	ld
位	ww	rl
微	ww	rj
未	ww	am
围	ww	kw
卫	ww	ea
威	ww	wn
味	ww	kw
维	ww	sv
危	ww	dv
委	ww	hn
伟	ww	rw
谓	ww	yo
唯	ww	kv
慰	ww	ux
尾	ww	um
喂	ww	ky
魏	ww	hg
薇	ww	cj
惟	ww	xv
违	ww	zw
韦	ww	fv
畏	ww	ty
伪	ww	rw
尉	ww	uc
胃	ww	to
巍	ww	ug
蔚	ww	cc
偎	ww	ry
萎	ww	cn
苇	ww	cw
炜	ww	hw
玮	ww	ww
猥	ww	qy
娓	ww	nm
帷	ww	jv
纬	ww	sw
渭	ww	do
桅	ww	mv
嵬	ww	ug
猬	ww	qo
隗	ww	eg
葳	ww	cn
痿	ww	bn
闱	ww	mw
煨	ww	hy
诿	ww	yn
韪	ww	ow
逶	ww	zn
帏	ww	jw
圩	ww	ty
潍	ww	dv
溦	ww	dj
鲔	ww	yo
艉	ww	vm
隈	ww	ey
洧	ww	do
沩	ww	dw
廆	ww	gg
霨	ww	yc
涠	ww	dw
亹	ww	wq
碨	ww	uy
煟	ww	ho
琟	ww	wv
硙	ww	uj
薳	ww	cy
峗	ww	uv
洈	ww	dv
螱	ww	ui
鳂	ww	yy
鳚	ww	yc
𣲗	ww	dw
𫇭	ww	cw
𬀩	ww	ow
𬱟	ww	dy
𬶏	ww	yv
问	wf	mk
文	wf	wx
温	wf	dm
闻	wf	me
稳	wf	hx
吻	wf	kw
纹	wf	sw
雯	wf	yw
蚊	wf	iw
芠	wf	cw
瘟	wf	bm
紊	wf	wx
汶	wf	dw
玟	wf	ww
刎	wf	wd
炆	wf	hw
璺	wf	jy
阌	wf	my
辒	wf	im
榅	wf	mm
蕰	wf	cm
鳁	wf	ym
𫘜	wf	mw
翁	wg	gx
嗡	wg	kx
瓮	wg	gw
蓊	wg	cx
蕹	wg	cv
滃	wg	dx
鹟	wg	gn
𬭩	wg	jx
我	wo	ga
握	wo	ft
窝	wo	bn
卧	wo	ib
沃	wo	dy
倭	wo	rn
龌	wo	vt
蜗	wo	in
渥	wo	dt
斡	wo	ud
幄	wo	jt
挝	wo	fc
莴	wo	cn
硪	wo	uw
肟	wo	ok
偓	wo	rt
涴	wo	dv
踒	wo	zn
物	wu	nw
五	wu	aw
武	wu	yv
务	wu	wl
屋	wu	ut
舞	wu	pf
吴	wu	kt
午	wu	pu
误	wu	yt
雾	wu	yl
乌	wu	pa
悟	wu	xk
伍	wu	rw
呜	wu	kw
巫	wu	gr
吾	wu	wk
污	wu	dk
捂	wu	fk
勿	wu	bp
兀	wu	ae
侮	wu	rm
唔	wu	kk
梧	wu	mk
妩	wu	nw
芜	wu	cw
诬	wu	yr
坞	wu	tw
毋	wu	mp
晤	wu	ok
蜈	wu	it
邬	wu	we
鹉	wu	yn
戊	wu	gp
忤	wu	xw
骛	wu	mm
鹜	wu	mn
仵	wu	rw
婺	wu	mn
钨	wu	jw
杌	wu	mw
焐	wu	hk
庑	wu	gw
寤	wu	bk
鋈	wu	dj
痦	wu	bk
怃	wu	xw
牾	wu	nk
圬	wu	tk
浯	wu	dk
芴	wu	cw
迕	wu	zw
鼯	wu	jk
旿	wu	ow
靰	wu	gw
洿	wu	dk
鹀	wu	gn
郚	wu	we
屼	wu	uw
珷	wu	wv
铻	wu	jk
峿	wu	uk
珸	wu	wk
𣲘	wu	dw
洗	xi	de
西	xi	ak
喜	xi	tk
息	xi	zx
细	xi	st
希	xi	xj
习	xi	vd
吸	xi	kj
戏	xi	yg
惜	xi	xo
席	xi	gj
袭	xi	ly
悉	xi	cx
嘻	xi	kk
析	xi	mj
稀	xi	hj
熙	xi	ih
夕	xi	pd
晰	xi	oj
溪	xi	dd
兮	xi	bk
牺	xi	nx
膝	xi	ou
媳	xi	nx
隙	xi	eo
昔	xi	co
锡	xi	jw
嬉	xi	nk
熄	xi	hx
犀	xi	un
曦	xi	ok
禧	xi	pk
皙	xi	mb
玺	xi	dy
汐	xi	dx
蜥	xi	ij
奚	xi	vd
唏	xi	kj
羲	xi	yk
淅	xi	dj
徙	xi	rz
熹	xi	th
蟋	xi	ix
翕	xi	rx
檄	xi	mw
僖	xi	rk
窸	xi	bx
铣	xi	je
郗	xi	xe
晞	xi	oj
烯	xi	hj
屃	xi	ub
浠	xi	dj
阋	xi	me
樨	xi	mn
傒	xi	rd
醯	xi	ym
隰	xi	eh
螅	xi	ix
爔	xi	hk
屣	xi	uz
硒	xi	ux
釐	xi	wl
葸	xi	cx
咥	xi	kt
豨	xi	uj
禊	xi	pd
饩	xi	uq
郤	xi	ge
觋	xi	gj
穸	xi	bx
嶲	xi	uk
舄	xi	jh
舾	xi	vx
谿	xi	vg
恓	xi	xx
蓰	xi	cz
鼷	xi	jd
粞	xi	mx
巇	xi	ug
憙	xi	tx
绤	xi	sg
菥	xi	cj
枲	xi	sm
潟	xi	dh
肸	xi	ou
酅	xi	ue
睎	xi	oj
觿	xi	dk
嶍	xi	ub
暿	xi	ok
俙	xi	rj
熻	xi	hx
饻	xi	uy
鳛	xi	yb
𠅤	xi	wx
𫘬	xi	md
𬭳	xi	jk
𬶮	xi	yk
下	xx	ab
夏	xx	bw
侠	xx	rj
霞	xx	yy
瞎	xx	ok
狭	xx	qj
暇	xx	oy
峡	xx	uj
虾	xx	ix
辖	xx	ik
匣	xx	kj
瑕	xx	wy
遐	xx	zy
黠	xx	lk
呷	xx	kj
狎	xx	qj
罅	xx	fh
硖	xx	uj
柙	xx	mj
叚	xx	uy
翈	xx	jx
先	xm	ne
现	xm	wj
显	xm	oy
线	xm	sj
险	xm	eq
仙	xm	ru
咸	xm	wk
鲜	xm	yy
限	xm	eg
闲	xm	mm
陷	xm	ej
县	xm	qs
献	xm	uq
贤	xm	lb
嫌	xm	nj
羡	xm	yq
弦	xm	gx
掀	xm	fq
宪	xm	be
衔	xm	rj
娴	xm	nm
涎	xm	dv
馅	xm	uj
舷	xm	vx
腺	xm	ou
暹	xm	zv
苋	xm	cj
冼	xm	de
藓	xm	cy
锨	xm	jq
霰	xm	yw
跹	xm	zq
忺	xm	xq
痫	xm	bm
祆	xm	pt
岘	xm	uj
酰	xm	ye
跣	xm	ze
燹	xm	uh
狝	xm	qx
蚬	xm	ij
猃	xm	qq
籼	xm	mu
鹇	xm	mn
筅	xm	ve
莶	xm	cq
氙	xm	qu
挦	xm	fc
崄	xm	uq
缐	xm	su
孅	xm	nj
伭	xm	rx
禒	xm	pu
㬎	xm	oh
𪾢	xm	oj
𫍯	xm	yk
𬀪	xm	oj
𬸣	xm	bn
想	xl	mx
向	xl	pk
相	xl	mo
像	xl	ru
象	xl	du
响	xl	kk
香	xl	ho
项	xl	gy
乡	xl	vp
享	xl	wz
翔	xl	yx
箱	xl	vo
祥	xl	py
详	xl	yy
湘	xl	do
厢	xl	io
襄	xl	yf
镶	xl	jf
橡	xl	mu
饷	xl	uk
骧	xl	mf
飨	xl	xg
庠	xl	gy
缃	xl	so
芗	xl	cx
鲞	xl	jy
瓖	xl	wf
葙	xl	co
珦	xl	wk
𬙋	xl	sf
小	xn	lb
笑	xn	vy
消	xn	do
晓	xn	ow
萧	xn	cb
效	xn	ww
销	xn	jo
肖	xn	xo
啸	xn	kb
孝	xn	lz
逍	xn	zo
潇	xn	db
削	xn	xd
嚣	xn	kk
霄	xn	yo
宵	xn	bo
哮	xn	kz
箫	xn	vb
筱	xn	vw
枭	xn	nm
硝	xn	uo
骁	xn	mw
淆	xn	do
魈	xn	go
绡	xn	so
哓	xn	kw
鸮	xn	kn
崤	xn	uo
枵	xn	mk
猇	xn	qj
洨	xn	df
翛	xn	rx
虓	xn	jj
涍	xn	dz
蟏	xn	ib
敩	xn	xw
滧	xn	dw
皛	xn	bb
𫍲	xn	yy
些	xp	ve
血	xp	pm
谢	xp	yc
写	xp	by
邪	xp	ye
协	xp	ub
鞋	xp	gt
斜	xp	rd
泄	xp	du
胁	xp	ob
歇	xp	oq
屑	xp	uo
械	xp	mc
携	xp	fn
谐	xp	yb
卸	xp	ve
挟	xp	fj
泻	xp	dy
懈	xp	xn
蝎	xp	ir
蟹	xp	di
亵	xp	yw
邂	xp	zn
偕	xp	rb
榭	xp	mc
燮	xp	hy
楔	xp	md
撷	xp	fy
瀣	xp	dj
獬	xp	qn
勰	xp	lx
廨	xp	gn
缬	xp	sy
躞	xp	zy
绁	xp	su
渫	xp	dm
薤	xp	cj
榍	xp	mo
揳	xp	fd
澥	xp	dn
薢	xp	cn
叶	xp	ku
㙦	xp	rt
偰	xp	rd
𤫉	xp	wy
𬹼	xp	vj
新	xb	lj
心	xb	dd
信	xb	rk
欣	xb	jq
辛	xb	lu
馨	xb	to
薪	xb	cj
歆	xb	lq
昕	xb	oj
衅	xb	pb
芯	xb	cx
鑫	xb	jj
忻	xb	xj
锌	xb	jx
炘	xb	hj
囟	xb	px
伈	xb	rx
䜣	xb	yj
𫷷	xb	gq
性	xk	xu
星	xk	ou
形	xk	kp
兴	xk	xb
醒	xk	yu
幸	xk	tg
型	xk	kt
姓	xk	nu
刑	xk	kd
腥	xk	ou
杏	xk	mk
猩	xk	qu
惺	xk	xu
邢	xk	ke
悻	xk	xg
荥	xk	cu
擤	xk	fw
陉	xk	ej
荇	xk	cd
饧	xk	up
骍	xk	mx
硎	xk	ud
钘	xk	jk
瑆	xk	wu
婞	xk	ng
铏	xk	jd
煋	xk	hu
𫰛	xk	nj
兄	xs	ke
胸	xs	ox
雄	xs	uv
凶	xs	kx
熊	xs	sh
汹	xs	dx
匈	xs	bx
芎	xs	cg
讻	xs	yx
夐	xs	dw
诇	xs	yk
修	xq	rp
秀	xq	hn
休	xq	rm
羞	xq	yi
袖	xq	py
绣	xq	sn
嗅	xq	kq
朽	xq	mk
锈	xq	jn
咻	xq	km
岫	xq	uy
貅	xq	vm
馐	xq	ui
庥	xq	gm
脩	xq	ro
溴	xq	dq
琇	xq	wn
髹	xq	em
鸺	xq	rn
珛	xq	wo
滫	xq	do
䗛	xq	io
许	xu	yw
续	xu	sd
需	xu	ye
须	xu	py
虚	xu	hy
徐	xu	rm
绪	xu	so
序	xu	gy
旭	xu	jo
叙	xu	ry
蓄	xu	ct
吁	xu	ky
絮	xu	nx
婿	xu	no
恤	xu	xm
栩	xu	mx
墟	xu	ty
诩	xu	yx
煦	xu	oh
胥	xu	zo
酗	xu	yx
顼	xu	wy
勖	xu	ol
蓿	xu	cb
盱	xu	oy
魆	xu	gl
洫	xu	dm
溆	xu	dy
糈	xu	mo
谞	xu	yo
媭	xu	pn
昫	xu	oj
醑	xu	yo
珝	xu	wx
旴	xu	oy
湑	xu	do
垿	xu	ty
㳚	xu	dd
冔	xu	oy
𦈡	xu	se
𬣙	xu	yy
选	xr	ze
玄	xr	wy
宣	xr	bd
旋	xr	fz
轩	xr	ig
悬	xr	qx
喧	xr	kd
璇	xr	wz
眩	xr	ox
炫	xr	hx
萱	xr	cd
漩	xr	dz
绚	xr	so
暄	xr	od
渲	xr	dd
煊	xr	hd
泫	xr	dx
铉	xr	jx
瑄	xr	wd
烜	xr	hd
癣	xr	by
禤	xr	px
谖	xr	yy
儇	xr	ry
玹	xr	wx
楦	xr	md
碹	xr	ud
晅	xr	od
衒	xr	rx
翾	xr	sx
痃	xr	bx
昡	xr	ox
咺	xr	kd
暶	xr	oz
愃	xr	xd
琄	xr	wo
𫍽	xr	yy
𫓶	xr	jo
𫠊	xr	mx
学	xt	xz
雪	xt	ye
穴	xt	bb
薛	xt	cx
靴	xt	gb
谑	xt	ye
噱	xt	ku
踅	xt	fz
鳕	xt	ye
茓	xt	cb
峃	xt	xu
寻	xy	ec
训	xy	yi
迅	xy	zu
巡	xy	zv
讯	xy	yu
询	xy	yo
逊	xy	zx
循	xy	ro
勋	xy	kl
熏	xy	qh
旬	xy	bo
驯	xy	mi
荀	xy	co
薰	xy	ch
殉	xy	do
醺	xy	yh
洵	xy	do
峋	xy	uo
巽	xy	sg
珣	xy	wo
汛	xy	du
徇	xy	ro
浔	xy	dc
埙	xy	tb
恂	xy	xo
蕈	xy	cu
鲟	xy	yc
曛	xy	oh
獯	xy	qh
噀	xy	kg
栒	xy	mo
𫄸	xy	sh
𬊈	xy	hc
𬍤	xy	wc
𬘓	xy	si
𬩽	xy	ee
呀	ya	ky
亚	ya	ay
压	ya	id
雅	ya	yv
牙	ya	gp
丫	ya	bl
讶	ya	yy
涯	ya	dt
哑	ya	ky
崖	ya	ut
娅	ya	ny
押	ya	fj
鸭	ya	jn
鸦	ya	yn
衙	ya	rk
芽	ya	cy
伢	ya	ry
琊	ya	we
桠	ya	my
睚	ya	ot
垭	ya	ty
岈	ya	uy
迓	ya	zy
蚜	ya	iy
玡	ya	wy
揠	ya	fn
猰	ya	qd
氩	ya	qy
砑	ya	uy
堐	ya	tt
眼	yj	og
言	yj	wk
严	yj	ai
烟	yj	hy
演	yj	db
验	yj	mq
研	yj	uk
燕	yj	ch
颜	yj	wy
掩	yj	fd
延	yj	zv
厌	yj	iq
艳	yj	fb
炎	yj	hh
沿	yj	dk
焰	yj	hj
岩	yj	uu
淹	yj	dd
咽	yj	ky
宴	yj	bn
嫣	yj	nh
妍	yj	nk
彦	yj	wp
雁	yj	iv
阎	yj	mj
盐	yj	tm
焉	yj	vh
衍	yj	rd
檐	yj	mk
奄	yj	dd
砚	yj	uj
焱	yj	hh
俨	yj	ry
晏	yj	on
胭	yj	oy
蜒	yj	iv
魇	yj	ig
阉	yj	md
湮	yj	dt
琰	yj	wh
筵	yj	vv
偃	yj	rn
闫	yj	ms
阏	yj	md
恹	yj	xq
谚	yj	yp
兖	yj	ly
堰	yj	tn
鄢	yj	ve
滟	yj	db
赝	yj	ib
唁	yj	kk
鼹	yj	jn
芫	yj	cy
郾	yj	ke
酽	yj	yy
餍	yj	ig
厣	yj	ij
谳	yj	yq
崦	yj	ud
弇	yj	rc
黡	yj	ih
罨	yj	sd
渰	yj	dc
掞	yj	fh
嬿	yj	nh
棪	yj	mh
扊	yj	hh
沇	yj	dy
甗	yj	hw
殷	yj	pu
䶮	yj	lt
墕	yj	th
戭	yj	bg
漹	yj	dh
虤	yj	hj
蝘	yj	in
觃	yj	jz
𪩘	yj	uq
𫄧	yj	sv
𬙂	yj	sb
𬸘	yj	kn
养	yh	yl
样	yh	my
阳	yh	eo
杨	yh	mp
扬	yh	fp
洋	yh	dy
仰	yh	re
央	yh	kr
羊	yh	bf
痒	yh	by
漾	yh	dy
氧	yh	qy
恙	yh	yx
佯	yh	ry
鸯	yh	yn
殃	yh	dy
怏	yh	xy
秧	yh	hy
炀	yh	hp
泱	yh	dy
鞅	yh	gy
徉	yh	ry
烊	yh	hy
疡	yh	bp
旸	yh	op
飏	yh	fp
羕	yh	yy
蛘	yh	iy
垟	yh	ty
玚	yh	wp
咉	yh	ky
钖	yh	jp
要	yc	xn
摇	yc	ff
药	yc	cu
妖	yc	ny
腰	yc	on
咬	yc	kf
遥	yc	zf
耀	yc	gv
瑶	yc	wf
姚	yc	nv
邀	yc	zw
钥	yc	jo
夭	yc	pd
谣	yc	yf
幺	yc	vs
窑	yc	bf
尧	yc	yw
吆	yc	ky
肴	yc	xo
约	yc	su
曜	yc	ov
窈	yc	bl
杳	yc	mo
舀	yc	vj
爻	yc	xx
鹞	yc	vn
徭	yc	rf
轺	yc	ik
鳐	yc	yf
崾	yc	un
窅	yc	bo
峣	yc	uw
垚	yc	tt
珧	yc	wv
靿	yc	gl
猺	yc	qf
媱	yc	nf
㙘	yc	tn
也	ye	vv
业	ye	la
夜	ye	ww
爷	ye	fe
野	ye	ly
液	ye	dw
耶	ye	ee
页	ye	ab
曳	ye	yp
冶	ye	dk
烨	ye	hu
噎	ye	kb
腋	ye	ow
靥	ye	im
椰	ye	me
掖	ye	fw
晔	ye	ou
邺	ye	ye
谒	ye	yr
揶	ye	fe
铘	ye	je
倻	ye	re
馌	ye	um
以	yi	lr
已	yi	kv
一	yi	aa
意	yi	lx
衣	yi	wy
亿	yi	rv
易	yi	ow
依	yi	ry
义	yi	dx
异	yi	sc
疑	yi	bz
议	yi	yy
医	yi	ku
伊	yi	ry
移	yi	hx
忆	yi	xv
艺	yi	cv
亦	yi	wb
翼	yi	xg
遗	yi	zb
益	yi	bm
宜	yi	bq
椅	yi	mk
仪	yi	ry
逸	yi	zt
姨	yi	ny
怡	yi	xk
抑	yi	fe
毅	yi	lu
役	yi	ru
译	yi	yf
夷	yi	ar
溢	yi	dm
咦	yi	ky
倚	yi	rk
矣	yi	su
谊	yi	yq
乙	yi	vv
蚁	yi	iy
奕	yi	wd
漪	yi	dk
疫	yi	bu
绎	yi	sf
裔	yi	yk
揖	yi	fe
颐	yi	iy
驿	yi	mf
弈	yi	wc
懿	yi	tx
邑	yi	kb
熠	yi	hb
屹	yi	uv
沂	yi	dj
羿	yi	xc
诣	yi	yo
翌	yi	xl
轶	yi	if
呓	yi	kv
翊	yi	lx
蜴	yi	iw
弋	yi	yd
咿	yi	ky
旖	yi	fk
祎	yi	pw
臆	yi	ox
彝	yi	hc
贻	yi	bk
噫	yi	kx
佚	yi	rf
迤	yi	zy
壹	yi	tb
缢	yi	sm
翳	yi	kx
胰	yi	oy
痍	yi	by
薏	yi	cx
嶷	yi	uz
饴	yi	uk
苡	yi	cr
悒	yi	xb
猗	yi	qk
诒	yi	yk
黟	yi	lx
峄	yi	uf
镱	yi	jx
怿	yi	xf
眙	yi	ok
肄	yi	by
铱	yi	jy
挹	yi	fb
乂	yi	pn
刈	yi	xd
癔	yi	bx
镒	yi	jm
埸	yi	tw
佾	yi	ro
圯	yi	ts
瘗	yi	bt
燚	yi	hh
劓	yi	zd
殪	yi	db
浥	yi	db
扆	yi	hy
廙	yi	gg
簃	yi	vx
嫕	yi	nx
舣	yi	vy
杙	yi	my
钇	yi	jv
鹢	yi	bn
宧	yi	bi
洢	yi	dy
酏	yi	yy
繄	yi	kx
裛	yi	yb
椸	yi	my
踦	yi	zk
扅	yi	hx
佁	yi	rk
勚	yi	ul
匜	yi	ky
鹝	yi	gn
㑊	yi	rb
枍	yi	mk
潩	yi	dg
螠	yi	im
𫄷	yi	sx
𫖮	yi	uy
𬟁	yi	cn
𬬩	yi	jy
𬺈	yi	vk
因	yb	kd
音	yb	lo
引	yb	gl
隐	yb	ex
银	yb	jg
阴	yb	eo
印	yb	pe
吟	yb	kv
饮	yb	uq
淫	yb	dw
姻	yb	ny
尹	yb	ep
茵	yb	cy
瘾	yb	bx
胤	yb	eo
荫	yb	co
寅	yb	bb
垠	yb	tg
氤	yb	qy
蚓	yb	il
喑	yb	ko
洇	yb	dy
龈	yb	vg
鄞	yb	ce
夤	yb	xb
窨	yb	bo
霪	yb	yw
狺	yb	qk
愔	yb	xo
堙	yb	tt
訚	yb	mk
吲	yb	kl
铟	yb	jy
嚚	yb	kk
禋	yb	pt
骃	yb	my
慭	yb	lx
硍	yb	ug
珢	yb	wg
茚	yb	ce
蟫	yb	iu
龂	yb	vj
崟	yb	uj
溵	yb	du
歅	yb	xq
䲟	yb	ye
𬘡	yb	sy
𬤇	yb	yt
𬮱	yb	mt
应	yk	ga
影	yk	op
英	yk	cy
营	yk	ck
迎	yk	ze
硬	yk	ug
鹰	yk	gn
赢	yk	wb
映	yk	oy
莹	yk	cy
盈	yk	nm
婴	yk	bn
樱	yk	mn
颖	yk	by
莺	yk	cn
蝇	yk	id
嬴	yk	wn
萤	yk	ci
荧	yk	ch
萦	yk	cx
瑛	yk	wy
缨	yk	sn
瀛	yk	dn
嘤	yk	kn
膺	yk	go
滢	yk	dy
鹦	yk	bn
罂	yk	bf
璎	yk	wn
郢	yk	ke
颍	yk	by
茔	yk	ct
楹	yk	mm
撄	yk	fn
潆	yk	dx
媵	yk	on
瘿	yk	bn
锳	yk	jy
蓥	yk	cj
溁	yk	dm
媖	yk	ny
䓨	yk	cf
用	ys	kf
永	ys	du
拥	ys	fy
勇	ys	sl
佣	ys	ry
庸	ys	go
泳	ys	dy
雍	ys	wv
咏	ys	ky
甬	ys	sy
慵	ys	xo
俑	ys	ry
恿	ys	sx
臃	ys	ov
蛹	ys	iy
邕	ys	vb
踊	ys	zy
墉	ys	to
镛	ys	jo
颙	ys	ty
痈	ys	by
壅	ys	wt
饔	ys	wg
鳙	ys	yo
澭	ys	dv
鄘	ys	ge
埇	ys	ty
栐	ys	my
喁	ys	kd
㶲	ys	hy
鲬	ys	yy
有	yz	uo
又	yz	vn
由	yz	ol
友	yz	uy
游	yz	dz
右	yz	uk
优	yz	ry
犹	yz	qy
幽	yz	uy
油	yz	dy
尤	yz	yd
忧	yz	xy
悠	yz	rx
诱	yz	yn
幼	yz	yl
佑	yz	rk
邮	yz	ye
黝	yz	ll
呦	yz	kl
攸	yz	rw
鱿	yz	yy
酉	yz	xa
繇	yz	vx
柚	yz	my
祐	yz	pk
铀	yz	jy
猷	yz	bq
釉	yz	cy
莠	yz	cn
囿	yz	ko
鼬	yz	jy
宥	yz	bo
莜	yz	cw
疣	yz	by
侑	yz	ro
牖	yz	pf
蝣	yz	iz
蚴	yz	il
羑	yz	yj
蚰	yz	iy
莸	yz	cy
卣	yz	bk
麀	yz	lb
耰	yz	lw
浟	yz	dw
槱	yz	mh
铕	yz	jo
鲉	yz	yy
𬨎	yz	iy
与	yu	va
于	yu	au
语	yu	yk
雨	yu	ad
玉	yu	wd
余	yu	rm
遇	yu	zd
欲	yu	gq
羽	yu	xx
宇	yu	by
鱼	yu	da
预	yu	yy
御	yu	re
郁	yu	ue
豫	yu	yu
域	yu	ta
狱	yu	qq
予	yu	sl
愈	yu	rx
浴	yu	dg
誉	yu	xk
愉	yu	xd
愚	yu	tx
於	yu	fd
裕	yu	pg
娱	yu	nt
瑜	yu	wd
喻	yu	kd
寓	yu	bd
渔	yu	dy
虞	yu	ht
俞	yu	rd
禹	yu	pd
煜	yu	hl
舆	yu	jb
谕	yu	yd
逾	yu	zd
榆	yu	md
屿	yu	uy
钰	yu	jy
驭	yu	my
渝	yu	dd
迂	yu	zy
淤	yu	dd
毓	yu	pi
瑀	yu	wy
妤	yu	ny
昱	yu	ol
隅	yu	ed
禺	yu	td
芋	yu	cy
聿	yu	yg
臾	yu	jr
揄	yu	fd
峪	yu	ug
觎	yu	rj
妪	yu	nq
谀	yu	yr
腴	yu	or
盂	yu	ym
彧	yu	ga
庾	yu	gr
瘀	yu	bd
燏	yu	hk
棫	yu	ma
蜮	yu	ia
圄	yu	kk
竽	yu	vy
欤	yu	yq
萸	yu	cr
鹬	yu	mn
鬻	yu	gg
龉	yu	vk
窳	yu	bg
圉	yu	kg
纡	yu	sy
狳	yu	qm
俣	yu	rt
燠	yu	hd
瘐	yu	br
伛	yu	rq
饫	yu	uy
淯	yu	do
阈	yu	ma
蝓	yu	id
舁	yu	jc
遹	yu	zk
雩	yu	yk
鹆	yu	gn
窬	yu	bd
熨	yu	uh
玙	yu	wy
嵛	yu	ud
堉	yu	to
褕	yu	pd
矞	yu	mk
畬	yu	rt
嵎	yu	ud
蓣	yu	cy
髃	yu	gd
滪	yu	dy
潏	yu	dk
悆	yu	rx
敔	yu	ww
邘	yu	ye
鄅	yu	ye
艅	yu	vm
㺄	yu	qd
原	yr	ix
远	yr	zy
员	yr	kb
元	yr	aw
院	yr	ey
愿	yr	ix
园	yr	ky
源	yr	dx
圆	yr	kb
缘	yr	su
怨	yr	xx
援	yr	fy
袁	yr	ty
辕	yr	iy
渊	yr	dl
冤	yr	bt
媛	yr	ny
苑	yr	cv
猿	yr	qy
鸳	yr	xn
垣	yr	td
鸢	yr	yn
沅	yr	dy
爰	yr	vy
瑗	yr	wy
塬	yr	tx
鼋	yr	yd
掾	yr	fu
垸	yr	ty
螈	yr	ix
橼	yr	mu
蜎	yr	io
嫄	yr	nx
箢	yr	vv
湲	yr	dy
眢	yr	xo
妧	yr	ny
羱	yr	yx
𫘪	yr	mx
越	yt	tl
月	yt	ke
跃	yt	zy
岳	yt	qu
悦	yt	xx
曰	yt	ka
阅	yt	mx
粤	yt	pk
玥	yt	wo
钺	yt	jl
樾	yt	ml
刖	yt	od
彟	yt	ey
瀹	yt	dc
龠	yt	rc
爚	yt	hc
籥	yt	vc
𫐄	yt	iw
𬸚	yt	qn
云	yy	ag
运	yy	zy
晕	yy	oi
允	yy	se
韵	yy	ly
芸	yy	cy
孕	yy	nz
蕴	yy	cm
匀	yy	bd
陨	yy	eb
酝	yy	yy
愠	yy	xm
氲	yy	qm
耘	yy	ly
昀	yy	oy
纭	yy	sy
殒	yy	db
韫	yy	wm
郓	yy	be
赟	yy	wb
恽	yy	xi
鋆	yy	tj
郧	yy	ke
狁	yy	qy
沄	yy	dy
妘	yy	ny
缊	yy	sm
煴	yy	hm
筼	yy	vb
涢	yy	db
馧	yy	hm
𫖳	yy	yy
咋	za	kv
砸	za	uj
杂	za	jm
咂	za	kj
匝	za	kj
扎	za	fv
臜	za	ob
拶	za	fx
在	zd	ut
再	zd	ar
载	zd	gi
灾	zd	bh
宰	zd	bx
栽	zd	gm
哉	zd	gk
仔	zd	rz
崽	zd	ux
甾	zd	vt
咱	zj	kz
赞	zj	nb
暂	zj	io
簪	zj	vo
瓒	zj	wb
錾	zj	ij
糌	zj	mo
趱	zj	tb
昝	zj	wo
酂	zj	ne
寁	zj	bz
脏	zh	ot
葬	zh	cc
赃	zh	bt
臧	zh	vi
奘	zh	pd
牂	zh	py
驵	zh	mq
早	zc	ou
造	zc	zk
遭	zc	zo
糟	zc	mo
澡	zc	dm
躁	zc	zm
燥	zc	hm
凿	zc	yg
噪	zc	km
灶	zc	ht
枣	zc	ud
皂	zc	bq
藻	zc	cm
蚤	zc	ii
唣	zc	kq
璪	zc	wm
慥	zc	xk
簉	zc	vk
𥖨	zc	um
则	ze	bd
责	ze	fb
择	ze	ff
泽	ze	df
啧	ze	kb
仄	ze	ir
笮	ze	vv
帻	ze	jb
赜	ze	ib
昃	ze	or
舴	ze	vv
箦	ze	vb
迮	ze	zv
贼	zw	bu
鲗	zw	yd
怎	zf	vx
谮	zf	yo
增	zg	to
赠	zg	bo
憎	zg	xo
锃	zg	jw
缯	zg	so
甑	zg	bw
罾	zg	so
矰	zg	uo
鄫	zg	be
综	zg	su
䎖	zg	bx
炸	va	hv
眨	va	of
诈	va	yv
乍	va	pe
渣	va	dd
札	va	mv
闸	va	mj
榨	va	mv
吒	va	kq
咤	va	kq
蚱	va	iv
铡	va	jd
楂	va	md
鲊	va	yv
揸	va	fd
砟	va	uv
哳	va	kj
奓	va	dx
拃	va	fv
挓	va	fq
痄	va	bv
劄	va	vd
霅	va	yk
柞	va	mv
䃎	va	ux
溠	va	dg
鲝	va	yy
齇	va	zq
寨	vd	bm
宅	vd	bq
摘	vd	fg
债	vd	rb
窄	vd	bv
斋	vd	we
瘵	vd	bu
豸	vd	pp
站	vj	lv
战	vj	vg
展	vj	uy
占	vj	bk
斩	vj	ij
沾	vj	dv
蘸	vj	ch
绽	vj	sz
栈	vj	mj
盏	vj	jm
詹	vj	dk
湛	vj	db
崭	vj	uj
瞻	vj	ok
辗	vj	iy
毡	vj	mv
旃	vj	fd
谵	vj	yk
搌	vj	fy
飐	vj	fv
鹯	vj	wn
偡	vj	rb
栴	vj	md
鳣	vj	yd
𫗴	vj	ud
张	vh	gi
章	vh	lu
掌	vh	xu
丈	vh	an
帐	vh	ji
仗	vh	rv
障	vh	eu
涨	vh	di
杖	vh	mv
账	vh	bi
璋	vh	wu
胀	vh	oi
彰	vh	lp
蟑	vh	iu
瘴	vh	bu
樟	vh	mu
漳	vh	du
獐	vh	qu
嶂	vh	uu
幛	vh	ju
鄣	vh	le
嫜	vh	nu
暲	vh	ou
仉	vh	rj
找	vc	fg
照	vc	oh
招	vc	fk
赵	vc	tx
罩	vc	su
着	vc	yo
爪	vc	in
昭	vc	ok
兆	vc	ed
诏	vc	yk
沼	vc	dk
肇	vc	hy
钊	vc	jd
棹	vc	mu
笊	vc	vv
曌	vc	og
啁	vc	kk
旐	vc	fv
𬬿	vc	jk
𬶐	vc	yv
这	ve	zw
者	ve	lo
哲	ve	fk
遮	ve	zh
浙	ve	dj
辙	ve	iw
辄	ve	iv
褶	ve	pb
蛰	ve	fi
蔗	ve	ch
蜇	ve	fi
鹧	ve	gn
喆	ve	tk
谪	ve	yg
赭	ve	io
柘	ve	mu
磔	ve	um
锗	ve	jo
啫	ve	ko
晢	ve	fo
詟	ve	lk
䗪	ve	gi
真	vf	ub
阵	vf	ei
震	vf	yi
镇	vf	jb
珍	vf	wp
针	vf	ju
振	vf	fi
朕	vf	ot
侦	vf	rb
贞	vf	bb
枕	vf	me
诊	vf	yp
甄	vf	xw
帧	vf	jb
斟	vf	cd
祯	vf	pb
臻	vf	gh
桢	vf	mb
箴	vf	vk
缜	vf	sb
圳	vf	ti
榛	vf	mh
赈	vf	bi
蓁	vf	ch
禛	vf	pb
疹	vf	bp
砧	vf	uv
鸩	vf	bn
轸	vf	ip
稹	vf	hb
浈	vf	db
瑧	vf	wh
畛	vf	tp
胗	vf	op
鬒	vf	eb
袗	vf	pp
葴	vf	ck
揕	vf	fb
昣	vf	op
纼	vf	sl
正	vg	av
整	vg	uv
政	vg	vw
争	vg	dy
证	vg	yv
征	vg	rv
郑	vg	be
睁	vg	oy
挣	vg	fy
怔	vg	xv
症	vg	bv
蒸	vg	ch
铮	vg	jy
筝	vg	vy
狰	vg	qy
拯	vg	fi
峥	vg	uy
钲	vg	jv
诤	vg	yy
烝	vg	lh
只	vi	kb
之	vi	dn
知	vi	uk
直	vi	uq
至	vi	gt
指	vi	fo
值	vi	rq
制	vi	nd
支	vi	uy
志	vi	tx
止	vi	lb
治	vi	dk
质	vi	ib
置	vi	sq
致	vi	gw
职	vi	ev
智	vi	uo
纸	vi	su
织	vi	sv
执	vi	fw
枝	vi	mv
植	vi	mq
旨	vi	bo
芝	vi	cv
吱	vi	kv
肢	vi	ov
侄	vi	rt
脂	vi	oo
址	vi	tv
汁	vi	du
滞	vi	dj
稚	vi	hv
掷	vi	fe
秩	vi	hf
窒	vi	bt
芷	vi	cv
挚	vi	fu
蜘	vi	ik
帜	vi	jv
炙	vi	xh
趾	vi	zv
咫	vi	iv
痣	vi	bx
徵	vi	rw
雉	vi	uv
祗	vi	pu
栀	vi	mv
痔	vi	bc
栉	vi	me
祉	vi	pv
桎	vi	mt
蛭	vi	it
鸷	vi	fn
郅	vi	ge
踯	vi	ze
贽	vi	fb
陟	vi	eu
骘	vi	em
彘	vi	hb
跖	vi	zu
轾	vi	it
摭	vi	fh
枳	vi	mv
酯	vi	yo
帙	vi	jf
禔	vi	pz
卮	vi	iv
沚	vi	dv
胝	vi	ou
觯	vi	du
絷	vi	fx
埴	vi	tq
轵	vi	iv
黹	vi	yx
踬	vi	zb
忮	vi	xv
晊	vi	ot
畤	vi	tc
滍	vi	di
稙	vi	hq
扺	vi	fu
铚	vi	jt
锧	vi	jb
疐	vi	uz
跱	vi	zc
庤	vi	gc
泜	vi	du
梽	vi	mx
榰	vi	mo
𦭜	vi	cv
𬃊	vi	mb
中	vs	kl
终	vs	sd
众	vs	rr
钟	vs	jv
忠	vs	vx
仲	vs	rv
衷	vs	yv
肿	vs	ov
冢	vs	bu
踵	vs	zv
盅	vs	vm
锺	vs	jv
舯	vs	vv
螽	vs	di
柊	vs	md
茽	vs	cv
周	vz	kk
州	vz	dl
皱	vz	dp
洲	vz	dv
咒	vz	kj
宙	vz	by
舟	vz	pd
骤	vz	mu
粥	vz	gm
肘	vz	oc
轴	vz	iy
昼	vz	id
帚	vz	ej
胄	vz	yo
纣	vz	sc
绉	vz	se
诌	vz	ye
妯	vz	ny
碡	vz	um
籀	vz	vt
酎	vz	yc
辀	vz	iv
赒	vz	bk
鸼	vz	vn
荮	vz	cc
婤	vz	nk
㑇	vz	re
㤘	vz	xe
住	vu	rv
主	vu	wt
注	vu	dv
助	vu	ql
著	vu	co
朱	vu	pw
珠	vu	ww
诸	vu	yo
逐	vu	zu
竹	vu	gg
猪	vu	qo
祝	vu	px
筑	vu	vf
柱	vu	mv
驻	vu	mv
嘱	vu	ky
烛	vu	hi
煮	vu	lh
蛛	vu	iw
株	vu	mw
铸	vu	jc
诛	vu	yw
竺	vu	ve
瞩	vu	oy
伫	vu	rv
拄	vu	fv
侏	vu	rw
贮	vu	bv
茱	vu	cw
洙	vu	dw
蛀	vu	iv
渚	vu	do
箸	vu	vo
炷	vu	hv
铢	vu	jw
躅	vu	zi
苎	vu	cv
杼	vu	my
翥	vu	lx
槠	vu	mo
麈	vu	lv
潴	vu	do
舳	vu	vy
邾	vu	pe
纻	vu	sv
橥	vu	qm
砫	vu	uv
柷	vu	mx
疰	vu	bv
蠋	vu	ii
瘃	vu	bu
𬣞	vu	yv
抓	vx	fv
髽	vx	er
拽	vk	fy
转	vr	iv
专	vr	ts
赚	vr	bj
砖	vr	uv
撰	vr	fg
篆	vr	vu
馔	vr	ug
颛	vr	uy
啭	vr	kv
僎	vr	rg
瑑	vr	wu
䏝	vr	ov
装	vl	ly
状	vl	lq
庄	vl	gt
撞	vl	fl
壮	vl	lt
妆	vl	ln
桩	vl	mt
追	vv	zl
坠	vv	et
缀	vv	sy
锥	vv	jv
惴	vv	xe
赘	vv	fb
椎	vv	mv
骓	vv	mv
缒	vv	sl
隹	vv	rv
准	vy	dv
谆	vy	yz
肫	vy	ot
窀	vy	bt
衠	vy	rb
𬘯	vy	sz
桌	vo	bm
卓	vo	bu
捉	vo	fz
琢	vo	wu
灼	vo	hu
拙	vo	fi
浊	vo	di
镯	vo	ji
酌	vo	yu
啄	vo	ku
茁	vo	ci
涿	vo	du
擢	vo	fv
斫	vo	uj
濯	vo	dv
倬	vo	ru
浞	vo	dz
诼	vo	yu
棁	vo	mx
禚	vo	ph
椓	vo	mu
晫	vo	ou
叕	vo	yy
汋	vo	du
䓬	vo	cu
䦃	vo	jo
𬸦	vo	fn
子	zi	la
自	zi	po
字	zi	bz
资	zi	db
紫	zi	vx
姿	zi	dn
滋	zi	dy
姊	zi	nd
咨	zi	dk
梓	zi	mx
孜	zi	zw
渍	zi	db
籽	zi	mz
恣	zi	dx
龇	zi	vb
辎	zi	it
淄	zi	dt
眦	zi	ob
滓	zi	dx
嗞	zi	ky
髭	zi	eb
孳	zi	bz
缁	zi	st
笫	zi	vd
锱	zi	jt
秭	zi	hd
赀	zi	vb
訾	zi	vk
觜	zi	vy
嵫	zi	uy
趑	zi	tq
孖	zi	zz
粢	zi	dm
鲻	zi	yt
镃	zi	jy
耔	zi	lz
鼒	zi	co
虸	zi	iz
鄑	zi	ye
总	zs	bx
宗	zs	bu
纵	zs	sr
踪	zs	zu
棕	zs	mu
鬃	zs	eu
粽	zs	mu
偬	zs	rx
倧	zs	ru
鬷	zs	gw
腙	zs	ou
疭	zs	br
走	zz	tz
奏	zz	it
揍	zz	ft
邹	zz	de
诹	zz	yy
驺	zz	me
陬	zz	ey
鄹	zz	ee
鲰	zz	yy
组	zu	sq
足	zu	kz
族	zu	fu
祖	zu	pq
阻	zu	eq
租	zu	hq
诅	zu	yq
俎	zu	rq
镞	zu	ju
菹	zu	cq
崒	zu	uu
珇	zu	wq
钻	zr	jv
攥	zr	fx
纂	zr	vx
缵	zr	sb
躜	zr	zb
最	zv	oy
嘴	zv	ky
罪	zv	sf
醉	zv	yu
蕞	zv	cy
槜	zv	mn
尊	zy	bc
遵	zy	zc
樽	zy	mc
鳟	zy	yc
撙	zy	fc
噂	zy	kc
僔	zy	rc
嶟	zy	uc
𨱔	zy	jc
做	zo	rw
作	zo	rv
坐	zo	tr
左	zo	ug
座	zo	gr
昨	zo	ov
佐	zo	rg
祚	zo	pv
嘬	zo	ky
酢	zo	yv
怍	zo	xv
胙	zo	ov
唑	zo	kr
捽	zo	fu
阼	zo	ev
岞	zo	uv
