啊	aa	kk
阿	aa	ek
吖	aa	ky
锕	aa	jk
腌	aa	od
爱	ai	py
哎	ai	kx
唉	ai	ku
艾	ai	cx
癌	ai	be
挨	ai	fu
矮	ai	un
哀	ai	wy
埃	ai	tu
碍	ai	uc
欸	ai	sr
砹	ai	ux
隘	ai	em
瑷	ai	wy
暧	ai	oy
毐	ai	uw
嗳	ai	ky
蔼	ai	cv
霭	ai	yv
锿	ai	jy
嗌	ai	km
嫒	ai	ny
叆	ai	ey
皑	ai	bj
按	an	fn
安	an	bn
案	an	bm
俺	an	rd
暗	an	oo
氨	an	qn
胺	an	on
庵	an	gd
岸	an	eg
鞍	an	gn
黯	an	ho
铵	an	jn
桉	an	mn
唵	an	kd
谙	an	yo
埯	an	td
盦	an	rm
垵	an	tn
犴	an	qg
鹌	an	dn
𩽾	an	an
昂	ah	oe
卬	ah	pe
盎	ah	ym
肮	ah	oj
奥	ao	pd
熬	ao	fh
嗷	ao	kw
凹	ao	la
澳	ao	dd
傲	ao	rw
敖	ao	fw
鳌	ao	fa
袄	ao	py
螯	ao	fi
拗	ao	fl
坳	ao	tl
獒	ao	fq
媪	ao	nm
岙	ao	ye
翱	ao	bx
遨	ao	zw
鏊	ao	fj
薁	ao	cd
懊	ao	xd
璈	ao	ww
鏖	ao	gj
骜	ao	fm
奡	ao	al
隩	ao	ed
聱	ao	fe
廒	ao	gw
嶅	ao	fe
吧	ba	kb
把	ba	fb
八	ba	pn
巴	ba	sl
拔	ba	fd
罢	ba	ss
叭	ba	kb
爸	ba	bb
扒	ba	fb
靶	ba	gb
钯	ba	jb
霸	ba	yo
疤	ba	bb
芭	ba	cb
耙	ba	lb
灞	ba	do
坝	ba	tr
捌	ba	fd
粑	ba	mb
跋	ba	zd
魃	ba	gd
鲃	ba	ab
妭	ba	nd
鲅	ba	ad
菝	ba	cd
羓	ba	yb
胈	ba	od
朳	ba	mb
笆	ba	vb
岜	ba	eb
蚆	ba	ib
白	bd	po
摆	bd	fs
拜	bd	uf
百	bd	ab
掰	bd	uu
败	bd	kw
柏	bd	mb
佰	bd	rb
稗	bd	hu
捭	bd	fu
伯	bd	rb
版	bj	py
班	bj	ww
半	bj	dl
板	bj	my
般	bj	vy
办	bj	ld
搬	bj	fy
拌	bj	fb
斑	bj	ww
伴	bj	rb
瓣	bj	lu
扮	bj	fd
扳	bj	fy
绊	bj	sb
颁	bj	br
坂	bj	ty
阪	bj	ey
钣	bj	jy
癍	bj	bw
攽	bj	bw
柈	bj	mb
瘢	bj	by
昄	bj	oy
湴	bj	dy
靽	bj	gb
𨭉	bj	wj
帮	bh	fj
棒	bh	ml
榜	bh	mf
磅	bh	uf
邦	bh	fe
绑	bh	se
镑	bh	jf
傍	bh	rf
蚌	bh	if
浜	bh	db
谤	bh	yf
梆	bh	me
膀	bh	of
搒	bh	ff
玤	bh	wf
蒡	bh	cf
塝	bh	tf
𠳐	bh	ke
包	bc	bs
宝	bc	by
报	bc	fy
保	bc	rm
爆	bc	hu
抱	bc	fs
薄	bc	cc
堡	bc	rt
曝	bc	ou
饱	bc	us
煲	bc	rh
鲍	bc	as
剥	bc	ed
暴	bc	ou
豹	bc	vu
刨	bc	bd
褒	bc	wy
苞	bc	cs
胞	bc	os
葆	bc	cm
鸨	bc	bn
炮	bc	hs
孢	bc	zs
雹	bc	ys
枹	bc	ms
龅	bc	vs
趵	bc	zu
褓	bc	pm
瀑	bc	du
被	bw	py
背	bw	lo
倍	bw	rk
呗	bw	kr
杯	bw	mb
北	bw	lb
贝	bw	kr
备	bw	wt
悲	bw	fx
碑	bw	uu
辈	bw	fi
钡	bw	jr
焙	bw	hk
邶	bw	le
卑	bw	pu
悖	bw	xz
孛	bw	uz
蓓	bw	ck
陂	bw	ey
碚	bw	uk
琲	bw	wf
惫	bw	wx
褙	bw	po
鹎	bw	pn
鞴	bw	gy
狈	bw	qr
棓	bw	mk
椑	bw	mu
糒	bw	my
臂	bw	uo
鐾	bw	uj
鞁	bw	gy
𬇙	bw	dr
本	bf	aa
奔	bf	dc
笨	bf	vb
苯	bf	cb
畚	bf	st
贲	bf	ur
锛	bf	jc
犇	bf	nn
坌	bf	bt
夯	bf	dl
倴	bf	rc
栟	bf	mk
崩	bg	eo
蹦	bg	zo
泵	bg	uu
甭	bg	by
绷	bg	so
嘣	bg	ko
迸	bg	zk
甏	bg	uw
琫	bg	wl
祊	bg	pf
镚	bg	jo
比	bi	bb
笔	bi	vm
逼	bi	zt
币	bi	pj
必	bi	dd
鼻	bi	zl
壁	bi	ut
彼	bi	iy
毕	bi	bu
避	bi	zu
碧	bi	wu
哔	bi	ku
闭	bi	mc
弊	bi	dc
璧	bi	uy
铋	bi	jb
敝	bi	dw
匕	bi	pv
毙	bi	bb
俾	bi	ru
鄙	bi	ke
婢	bi	nu
蔽	bi	cw
濞	bi	dl
庇	bi	gb
畀	bi	tl
陛	bi	et
弼	bi	gg
痹	bi	bl
吡	bi	kb
髀	bi	gu
妣	bi	nb
襞	bi	uy
屄	bi	ub
箅	bi	vl
滗	bi	dm
庳	bi	gu
芘	bi	cb
嬖	bi	un
沘	bi	db
毖	bi	bb
蓖	bi	cb
萆	bi	cu
裨	bi	pu
苾	bi	cb
愎	bi	xw
篦	bi	vb
荜	bi	cu
邲	bi	be
皕	bi	bb
薜	bi	cu
跸	bi	zu
咇	bi	kb
珌	bi	wb
舭	bi	vb
辟	bi	uu
佖	bi	rb
赑	bi	kr
荸	bi	cz
诐	bi	yy
筚	bi	vu
秕	bi	hb
狴	bi	qt
佛	bi	rf
觱	bi	xy
馝	bi	hb
泌	bi	db
秘	bi	hb
鲾	bi	at
坒	bi	bt
便	bm	rg
边	bm	zl
变	bm	wy
遍	bm	zc
编	bm	sc
贬	bm	kf
辩	bm	lu
扁	bm	hc
鞭	bm	gg
辨	bm	lu
蝙	bm	ic
卞	bm	dx
煸	bm	hc
弁	bm	sc
辫	bm	lu
匾	bm	kc
汴	bm	db
苄	bm	cb
昪	bm	oc
抃	bm	fb
笾	bm	vz
砭	bm	uf
鳊	bm	ac
萹	bm	cc
忭	bm	xb
碥	bm	uc
褊	bm	pc
𨚕	bm	se
𰻝	bl	zx
表	bn	fy
标	bn	mx
婊	bn	ny
飙	bn	qx
镖	bn	jx
彪	bn	hp
裱	bn	py
膘	bn	ox
杓	bn	mu
摽	bn	fx
鳔	bn	ax
镳	bn	jh
骉	bn	mm
熛	bn	hx
幖	bn	jx
骠	bn	mx
藨	bn	ch
儦	bn	rh
瀌	bn	dh
俵	bn	ry
飑	bn	js
瘭	bn	bx
脿	bn	oy
别	bp	kd
憋	bp	dx
鳖	bp	da
瘪	bp	bb
蹩	bp	dr
癿	bp	bv
宾	bb	bb
斌	bb	wv
彬	bb	mp
髌	bb	gb
鬓	bb	ab
豳	bb	eu
滨	bb	db
邠	bb	be
膑	bb	ob
缤	bb	sb
殡	bb	db
濒	bb	dr
摈	bb	fb
玢	bb	wd
傧	bb	rb
镔	bb	jb
槟	bb	mb
并	bk	bk
病	bk	bb
兵	bk	qb
冰	bk	du
饼	bk	uk
柄	bk	mb
丙	bk	an
禀	bk	wx
屏	bk	uk
秉	bk	pn
炳	bk	hb
昺	bk	ob
蛃	bk	ib
摒	bk	fk
邴	bk	be
波	bo	dy
博	bo	uc
播	bo	ft
拨	bo	fd
铂	bo	jb
搏	bo	fc
钵	bo	jb
啵	bo	ky
驳	bo	mx
勃	bo	ul
玻	bo	wy
脖	bo	oz
帛	bo	bj
跛	bo	zy
亳	bo	wq
箔	bo	vb
泊	bo	db
钹	bo	jd
渤	bo	dl
僰	bo	ar
擘	bo	uu
镈	bo	jc
菠	bo	cy
浡	bo	dz
舶	bo	vb
嶓	bo	et
膊	bo	oc
哱	bo	kz
砵	bo	ub
卜	bo	ld
踣	bo	zk
簸	bo	vy
鹁	bo	un
檗	bo	um
鲌	bo	ab
蕃	bo	ct
艴	bo	fb
馞	bo	hz
袯	bo	pd
饽	bo	uz
礴	bo	uc
欂	bo	mc
𬭛	bo	jy
不	bu	ad
部	bu	le
补	bu	pb
步	bu	vp
布	bu	uj
簿	bu	vc
钚	bu	jb
捕	bu	ff
卟	bu	kb
怖	bu	xj
晡	bu	of
埠	bu	tu
逋	bu	zf
哺	bu	kf
蔀	bu	ce
瓿	bu	lw
醭	bu	yn
埔	bu	tf
埗	bu	tp
𬷕	bu	fn
擦	ca	fx
嚓	ca	kx
才	cd	ap
菜	cd	cm
踩	cd	zm
猜	cd	qo
蔡	cd	cx
财	cd	kc
采	cd	pm
材	cd	mc
裁	cd	uy
彩	cd	pp
睬	cd	om
偲	cd	rx
惨	cj	xp
餐	cj	ll
残	cj	dj
参	cj	sp
蚕	cj	ti
粲	cj	lm
灿	cj	he
骖	cj	mp
惭	cj	xj
璨	cj	wm
黪	cj	hp
䅟	cj	hp
藏	ch	ci
仓	ch	rv
舱	ch	vv
苍	ch	cv
沧	ch	dv
鸧	ch	rn
伧	ch	rv
草	cc	cu
曹	cc	ao
槽	cc	mo
操	cc	fm
艹	cc	al
糙	cc	mz
屮	cc	
嘈	cc	ko
漕	cc	do
芔	cc	
肏	cc	rr
艚	cc	vo
螬	cc	io
𥕢	cc	uo
侧	ce	rd
测	ce	dd
册	ce	pa
策	ce	vn
厕	ce	id
恻	ce	xd
𤭢	cw	ww
岑	cf	ev
涔	cf	dv
层	cg	us
曾	cg	bo
蹭	cg	zo
噌	cg	ko
嶒	cg	eo
差	ia	yg
茶	ia	cm
查	ia	ma
插	ia	fj
叉	ia	yd
侘	ia	rq
茬	ia	ct
镲	ia	jx
察	ia	bx
猹	ia	qa
搽	ia	fm
槎	ia	mg
岔	ia	be
杈	ia	mi
檫	ia	mx
碴	ia	ua
姹	ia	nq
汊	ia	di
衩	ia	pi
锸	ia	jj
垞	ia	tq
诧	ia	yq
馇	ia	ua
刹	ia	xd
喳	ia	ka
蹅	ia	za
嵖	ia	ea
𥻗	ia	ma
拆	id	fi
柴	id	vm
钗	id	ji
豺	id	vc
虿	id	wi
侪	id	rl
瘥	id	bg
茝	id	cl
产	ij	lp
铲	ij	ji
馋	ij	ud
缠	ij	sl
禅	ij	pl
蝉	ij	il
掺	ij	fp
颤	ij	wr
搀	ij	fd
谗	ij	yd
浐	ij	di
婵	ij	nl
蟾	ij	ik
澶	ij	da
觇	ij	le
阐	ij	ml
镡	ij	ju
躔	ij	zt
谄	ij	yj
襜	ij	pk
刬	ij	jd
辿	ij	ze
忏	ij	xq
瀍	ij	dt
巉	ij	ed
韂	ij	gk
羼	ij	uy
廛	ij	gt
潺	ij	dz
梴	ij	mz
孱	ij	uz
蒇	ij	cr
啴	ij	kl
单	ij	bl
骣	ij	mz
镵	ij	jd
旵	ij	oe
冁	ij	bn
儳	ij	rd
𬊤	ij	hl
唱	ih	ko
场	ih	tp
长	ih	pn
常	ih	xj
厂	ih	ap
尝	ih	xs
肠	ih	op
昌	ih	oo
畅	ih	up
偿	ih	rs
敞	ih	xw
娼	ih	no
怅	ih	xi
鬯	ih	xb
倡	ih	ro
昶	ih	yo
猖	ih	qo
苌	ih	ci
嫦	ih	nj
氅	ih	xm
伥	ih	ri
鲳	ih	ao
菖	ih	co
徜	ih	ik
裳	ih	xy
阊	ih	mo
鲿	ih	as
惝	ih	xk
𬬮	ih	ji
超	ic	tk
抄	ic	fu
炒	ic	hu
朝	ic	uo
潮	ic	do
吵	ic	ku
钞	ic	ju
巢	ic	vg
嘲	ic	ko
焯	ic	hu
晁	ic	od
怊	ic	xk
绰	ic	su
弨	ic	gk
耖	ic	lu
车	ie	al
扯	ie	fv
撤	ie	fw
彻	ie	id
掣	ie	pu
澈	ie	dw
坼	ie	ti
尺	ie	un
砗	ie	ui
㬚	ie	ow
陈	if	ed
趁	if	tp
臣	if	kl
沉	if	dj
辰	if	in
尘	if	xt
琛	if	wm
抻	if	fu
嗔	if	kb
衬	if	pc
晨	if	on
称	if	hx
宸	if	bn
谶	if	yj
谌	if	yv
瞋	if	ob
忱	if	xv
梣	if	mv
煁	if	hv
榇	if	mm
龀	if	vb
疢	if	bh
棽	if	mv
碜	if	up
郴	if	me
𬘭	if	sm
成	ig	wv
城	ig	ti
呈	ig	kw
乘	ig	qn
撑	ig	fu
橙	ig	ma
程	ig	hw
秤	ig	hp
盛	ig	im
承	ig	vn
诚	ig	yi
丞	ig	la
逞	ig	zw
澄	ig	da
埕	ig	tw
惩	ig	ix
枨	ig	mi
骋	ig	mv
铖	ig	ji
澂	ig	dw
珵	ig	ww
琤	ig	wl
偁	ig	rr
蛏	ig	it
赪	ig	tr
酲	ig	yw
宬	ig	bi
塍	ig	ot
柽	ig	mt
瞠	ig	ot
珹	ig	wi
牚	ig	xy
憕	ig	xa
晟	ig	oi
铛	ig	je
裎	ig	pw
庱	ig	gw
吃	ii	kq
池	ii	dy
持	ii	fc
赤	ii	td
迟	ii	zi
齿	ii	vk
翅	ii	ux
敕	ii	uw
痴	ii	bk
驰	ii	my
耻	ii	ev
嗤	ii	ki
豉	ii	ay
斥	ii	pd
蚩	ii	vi
螭	ii	id
叱	ii	kb
彳	ii	pr
炽	ii	hb
笞	ii	vk
哧	ii	kd
媸	ii	ni
饬	ii	ul
侈	ii	rx
弛	ii	gy
褫	ii	pj
魑	ii	gd
摛	ii	fd
鸱	ii	dn
啻	ii	wk
瘛	ii	bx
漦	ii	wu
墀	ii	tn
茌	ii	cu
匙	ii	ob
眵	ii	ox
篪	ii	vj
傺	ii	rx
踟	ii	zk
胣	ii	oy
瓻	ii	xw
痓	ii	bt
𫄨	ii	sj
冲	is	dv
重	is	pa
充	is	we
虫	is	vd
宠	is	bl
崇	is	ex
铳	is	je
舂	is	fj
憧	is	xl
摏	is	fj
艟	is	vl
翀	is	xv
忡	is	xv
茺	is	ce
涌	is	dy
种	is	hv
珫	is	we
漴	is	dx
㳘	is	de
抽	iz	fy
丑	iz	va
臭	iz	zq
愁	iz	hx
瞅	iz	oh
仇	iz	rj
筹	iz	vc
稠	iz	hk
酬	iz	yv
雠	iz	rf
俦	iz	rc
绸	iz	sk
畴	iz	tc
瘳	iz	bp
惆	iz	xk
杻	iz	mi
犨	iz	rn
帱	iz	jc
椆	iz	mk
踌	iz	zc
侴	iz	rd
出	iu	vk
处	iu	wb
除	iu	eh
初	iu	pd
楚	iu	mr
厨	iu	ic
触	iu	di
褚	iu	po
杵	iu	mw
锄	iu	jl
储	iu	ro
怵	iu	xu
雏	iu	df
橱	iu	mc
畜	iu	wt
黜	iu	hi
刍	iu	de
俶	iu	ry
础	iu	ui
楮	iu	mo
矗	iu	uq
亍	iu	el
滁	iu	dh
绌	iu	si
樗	iu	mk
憷	iu	xr
斶	iu	ji
搐	iu	ft
摴	iu	fk
躇	iu	zo
蜍	iu	ih
濋	iu	dr
蹰	iu	zc
䝙	iu	vx
䢺	iu	ie
琡	iu	wy
𬺓	iu	vr
欻	ix	hr
踹	ik	ze
揣	ik	fe
搋	ik	fj
啜	ik	ky
穿	ir	by
传	ir	rv
船	ir	vk
川	ir	pl
串	ir	ll
氚	ir	qi
喘	ir	ke
钏	ir	ji
椽	ir	mu
舛	ir	xl
遄	ir	ze
床	il	gm
创	il	rd
窗	il	bw
闯	il	mm
疮	il	bv
怆	il	xv
幢	il	jl
噇	il	kl
吹	iv	kr
锤	iv	ji
捶	iv	fi
垂	iv	pa
槌	iv	mz
炊	iv	hr
圌	iv	ke
棰	iv	mi
倕	iv	ri
陲	iv	ei
纯	iy	st
春	iy	fo
蠢	iy	fi
唇	iy	ik
醇	iy	yz
椿	iy	mo
淳	iy	dz
蝽	iy	io
鹑	iy	wn
莼	iy	ct
瑃	iy	wo
䲠	iy	ao
堾	iy	to
𬭚	iy	jz
戳	io	xg
辍	io	iy
龊	io	vr
踔	io	zu
逴	io	zu
惙	io	xy
次	ci	dr
此	ci	vb
词	ci	yk
刺	ci	ad
赐	ci	kw
磁	ci	uy
茨	ci	cr
呲	ci	kb
辞	ci	qu
雌	ci	vf
瓷	ci	dw
祠	ci	pk
慈	ci	bx
泚	ci	db
疵	ci	bb
伺	ci	rk
玼	ci	wb
糍	ci	my
跐	ci	zb
茈	ci	cb
兹	ci	by
佽	ci	rr
鹚	ci	bn
莿	ci	cd
𫚖	ci	va
从	cs	rr
葱	cs	cx
聪	cs	ex
丛	cs	ra
琮	cs	wx
骢	cs	mx
悰	cs	xx
枞	cs	mr
璁	cs	wx
匆	cs	bd
淙	cs	dx
熜	cs	hx
囱	cs	pw
苁	cs	cr
凑	cz	dt
腠	cz	ot
辏	cz	it
粗	cu	mq
醋	cu	yo
促	cu	rr
簇	cu	vu
蹙	cu	wr
蹴	cu	zy
徂	cu	iq
猝	cu	qu
殂	cu	dq
卒	cu	wu
蔟	cu	cu
窜	cr	bi
蹿	cr	zi
汆	cr	ru
篡	cr	vs
爨	cr	ph
攒	cr	fr
撺	cr	fi
镩	cr	ji
催	cv	rf
崔	cv	ef
脆	cv	ov
翠	cv	xu
萃	cv	cu
啐	cv	ku
摧	cv	ff
淬	cv	du
粹	cv	mu
毳	cv	mm
璀	cv	wf
悴	cv	xu
瘁	cv	bu
漼	cv	df
缞	cv	sy
榱	cv	my
寸	cy	ad
存	cy	uz
村	cy	mc
邨	cy	te
皴	cy	sy
忖	cy	xc
错	co	jo
搓	co	fg
挫	co	ft
锉	co	jt
措	co	fo
厝	co	io
撮	co	fy
蹉	co	zg
矬	co	ut
痤	co	bt
瑳	co	wg
嵯	co	eg
鹾	co	lg
磋	co	ug
脞	co	ot
棤	co	mo
莝	co	ct
大	da	un
打	da	fd
答	da	vk
达	da	zd
搭	da	fk
哒	da	kz
妲	da	na
嗒	da	kk
鞑	da	gz
怛	da	xa
沓	da	uo
炟	da	ha
跶	da	zz
笪	da	va
耷	da	de
靼	da	ga
垯	da	tz
溚	da	dk
瘩	da	bk
褡	da	pk
荙	da	cz
鿎	da	uz
𨱏	da	jk
𫟼	da	jz
带	dd	fj
代	dd	ry
待	dd	ic
呆	dd	km
戴	dd	ub
贷	dd	rr
袋	dd	ry
黛	dd	rh
逮	dd	zn
岱	dd	re
殆	dd	dk
迨	dd	zk
呔	dd	kt
歹	dd	ax
玳	dd	wy
傣	dd	ru
怠	dd	sx
绐	dd	sk
埭	dd	tn
轪	dd	id
骀	dd	mk
叇	dd	ez
垈	dd	rt
但	dj	ra
蛋	dj	vi
弹	dj	gl
淡	dj	dh
丹	dj	pa
氮	dj	qh
胆	dj	oa
担	dj	fa
旦	dj	oa
啖	dj	kh
掸	dj	fl
澹	dj	dk
亶	dj	wa
石	dj	ak
诞	dj	yz
耽	dj	ev
惮	dj	xl
疍	dj	va
儋	dj	rk
聃	dj	er
殚	dj	dl
箪	dj	vl
憺	dj	xk
瘅	dj	bl
膻	dj	oa
眈	dj	ov
萏	dj	cj
赕	dj	kh
郸	dj	be
疸	dj	ba
𫢸	dj	rl
𬘘	dj	sv
当	dh	xe
党	dh	xe
档	dh	me
挡	dh	fe
荡	dh	cp
裆	dh	pe
宕	dh	bu
砀	dh	up
凼	dh	uk
珰	dh	we
谠	dh	ye
菪	dh	cu
垱	dh	te
筜	dh	ve
𣗋	dh	me
𬍡	dh	dy
到	dc	ad
道	dc	zz
刀	dc	vp
倒	dc	rd
岛	dc	pe
导	dc	sc
盗	dc	dm
叨	dc	kd
氘	dc	ql
稻	dc	hj
捣	dc	fe
纛	dc	fx
悼	dc	xu
蹈	dc	zj
祷	dc	pc
捯	dc	fd
忉	dc	xd
舠	dc	vd
鱽	dc	ad
的	de	bu
得	de	ic
地	de	ty
德	de	ix
锝	de	jc
嘚	de	kc
扽	df	ft
等	dg	vc
灯	dg	hd
登	dg	va
邓	dg	ye
蹬	dg	za
凳	dg	vj
瞪	dg	oa
噔	dg	ka
镫	dg	ja
戥	dg	og
磴	dg	ua
嶝	dg	ea
璒	dg	wa
第	di	vp
低	di	rd
滴	di	dk
底	di	gd
帝	di	wj
迪	di	zy
敌	di	qw
蒂	di	cj
抵	di	fd
笛	di	vy
递	di	zp
弟	di	bp
狄	di	qh
氐	di	ud
镝	di	jk
骶	di	gd
嫡	di	nk
棣	di	mn
堤	di	tr
邸	di	de
碲	di	uj
嘀	di	kk
睇	di	op
禘	di	pj
谛	di	yj
籴	di	rm
鞮	di	gr
砥	di	ud
涤	di	dm
菂	di	cu
荻	di	ch
诋	di	yd
觌	di	ue
娣	di	np
羝	di	yd
杕	di	md
柢	di	md
翟	di	xf
髢	di	ay
坻	di	td
茋	di	cd
缔	di	sj
踶	di	zr
媂	di	nj
提	di	fr
蹢	di	zk
玓	di	wu
䃅	di	ul
䗖	di	ij
𤧛	di	wj
𬱖	di	yr
嗲	dx	kx
点	dm	lh
店	dm	gk
电	dm	lv
垫	dm	ft
碘	dm	ub
殿	dm	uy
颠	dm	ur
典	dm	lb
滇	dm	db
甸	dm	bt
掂	dm	fk
簟	dm	vu
癫	dm	br
巅	dm	er
奠	dm	bd
靛	dm	fr
钿	dm	jt
踮	dm	zk
佃	dm	rt
玷	dm	wk
淀	dm	dr
惦	dm	xk
坫	dm	tk
癜	dm	by
扂	dm	hk
阽	dm	ek
琔	dm	wr
掉	dn	fu
调	dn	yk
吊	dn	kj
屌	dn	uj
叼	dn	kd
钓	dn	ju
雕	dn	kf
刁	dn	va
貂	dn	vk
凋	dn	dk
鲷	dn	ak
碉	dn	uk
铫	dn	jd
窎	dn	bn
铞	dn	jj
汈	dn	dd
跌	dp	zu
爹	dp	bx
叠	dp	yq
碟	dp	um
蝶	dp	im
迭	dp	zu
谍	dp	ym
牒	dp	pm
昳	dp	ou
鲽	dp	am
楪	dp	mm
喋	dp	km
堞	dp	tm
瓞	dp	gu
耋	dp	lt
垤	dp	tt
绖	dp	st
蹀	dp	zm
𫶇	dp	ej
定	dk	br
顶	dk	dr
丁	dk	al
盯	dk	od
订	dk	yd
钉	dk	jd
叮	dk	kd
鼎	dk	ov
町	dk	td
碇	dk	ur
腚	dk	or
锭	dk	jr
玎	dk	wd
啶	dk	kr
酊	dk	yd
仃	dk	rd
疔	dk	bd
耵	dk	ed
萣	dk	cr
丢	dq	ps
铥	dq	js
懂	ds	xv
动	ds	el
东	ds	ad
洞	ds	dk
冻	ds	dd
冬	ds	wd
董	ds	cv
栋	ds	md
咚	ds	kd
氡	ds	qd
侗	ds	rk
鸫	ds	dn
胴	ds	ok
峒	ds	ek
恫	ds	xk
硐	ds	uk
岽	ds	ed
垌	ds	tk
胨	ds	od
𬟽	ds	id
都	dz	le
斗	dz	du
抖	dz	fu
豆	dz	aa
逗	dz	za
兜	dz	pe
痘	dz	ba
陡	dz	er
窦	dz	bd
读	dz	yd
蔸	dz	ce
蚪	dz	iu
钭	dz	ju
篼	dz	ve
度	du	gy
赌	du	ko
毒	du	fm
堵	du	to
杜	du	mt
独	du	qi
渡	du	dy
督	du	uo
肚	du	ot
镀	du	jy
嘟	du	ke
笃	du	vm
睹	du	oo
蠹	du	ai
妒	du	nh
犊	du	nd
渎	du	dd
椟	du	md
牍	du	pd
阇	du	mo
厾	du	vs
芏	du	ct
黩	du	hd
髑	du	gi
𬭊	du	jt
端	dr	le
段	dr	py
短	dr	ua
断	dr	mj
椴	dr	my
锻	dr	jy
缎	dr	sy
耑	dr	ee
煅	dr	hy
塅	dr	ty
簖	dr	vj
瑖	dr	wy
对	dv	yc
队	dv	er
怼	dv	yx
堆	dv	tf
兑	dv	be
碓	dv	uf
祋	dv	py
㨃	dv	fz
吨	dy	kt
蹲	dy	zc
盾	dy	po
顿	dy	tr
炖	dy	ht
惇	dy	xz
钝	dy	jt
墩	dy	tw
遁	dy	zo
敦	dy	ww
趸	dy	wr
囤	dy	kt
盹	dy	ot
沌	dy	dt
镦	dy	jw
礅	dy	uw
蹾	dy	zw
砘	dy	ut
多	do	xx
躲	do	um
哆	do	kx
夺	do	dc
剁	do	jd
朵	do	jm
堕	do	et
舵	do	vb
跺	do	zm
铎	do	jl
踱	do	zy
惰	do	xo
垛	do	tm
咄	do	ki
掇	do	fy
埵	do	ti
亸	do	wl
驮	do	md
哚	do	km
剟	do	yd
裰	do	py
饳	do	ui
㙍	do	ty
额	ee	br
恶	ee	yx
呃	ee	kv
俄	ee	rw
饿	ee	uw
鹅	ee	wn
厄	ee	iv
讹	ee	yb
鳄	ee	ak
鄂	ee	ke
娥	ee	nw
腭	ee	ok
蛾	ee	iw
颚	ee	kr
锇	ee	jw
扼	ee	fv
莪	ee	cw
轭	ee	iv
萼	ee	ck
遏	ee	zv
谔	ee	yk
屙	ee	uk
鹗	ee	kn
愕	ee	xk
锷	ee	jk
峨	ee	ew
涐	ee	dw
垩	ee	yt
噩	ee	wk
崿	ee	ek
婀	ee	nk
哦	ee	kw
姶	ee	nk
苊	ee	cv
堨	ee	tv
𥔲	ee	uk
𫫇	ee	kx
诶	ei	yu
嗯	en	kx
恩	en	kx
摁	en	fx
蒽	en	cx
而	er	al
二	er	aa
儿	er	pv
耳	er	aa
尔	er	dx
贰	er	yr
饵	er	ue
迩	er	zx
铒	er	je
珥	er	we
鸸	er	en
洱	er	de
鲕	er	ae
耏	er	ep
陑	er	ee
咡	er	ke
发	fa	vd
法	fa	ds
伐	fa	rg
罚	fa	sd
阀	fa	mg
乏	fa	pv
筏	fa	vg
珐	fa	ws
垡	fa	rt
砝	fa	us
反	fj	py
饭	fj	uy
翻	fj	px
犯	fj	qv
范	fj	cv
泛	fj	df
凡	fj	jd
番	fj	pt
烦	fj	hr
返	fj	zy
帆	fj	jf
藩	fj	ct
繁	fj	px
梵	fj	mf
樊	fj	md
贩	fj	ky
钒	fj	jf
矾	fj	uf
幡	fj	jt
燔	fj	ht
氾	fj	dv
璠	fj	wt
蘩	fj	cx
蹯	fj	zt
畈	fj	ty
墦	fj	tt
𫔍	fj	jt
𬸪	fj	pn
放	fh	fw
方	fh	dw
防	fh	ef
房	fh	hf
仿	fh	rf
坊	fh	tf
芳	fh	cf
访	fh	yf
钫	fh	jf
昉	fh	of
纺	fh	sf
枋	fh	mf
鲂	fh	af
妨	fh	nf
舫	fh	vf
肪	fh	of
蚄	fh	if
邡	fh	fe
牥	fh	nf
非	fw	la
费	fw	fr
飞	fw	vd
肺	fw	ol
废	fw	gd
肥	fw	ob
菲	fw	cf
妃	fw	nj
匪	fw	kf
绯	fw	sf
斐	fw	fw
吠	fw	kq
沸	fw	df
霏	fw	yf
啡	fw	kf
腓	fw	of
榧	fw	mf
扉	fw	hf
淝	fw	db
蜚	fw	fi
朏	fw	oi
镄	fw	jr
诽	fw	yf
痱	fw	bf
翡	fw	fx
狒	fw	qf
鲱	fw	af
悱	fw	xf
芾	fw	cl
棐	fw	fm
剕	fw	fd
篚	fw	vf
𬴂	fw	mf
分	ff	bd
粉	ff	md
份	ff	rd
坟	ff	tw
芬	ff	cd
粪	ff	mb
焚	ff	mh
酚	ff	yd
汾	ff	dd
忿	ff	bx
愤	ff	xr
奋	ff	dt
偾	ff	rr
纷	ff	sd
氛	ff	qd
棻	ff	cm
吩	ff	kd
棼	ff	md
鲼	ff	ar
瀵	ff	db
翂	ff	xd
坋	ff	td
鼢	ff	jd
豮	ff	ur
𣸣	ff	dr
风	fg	jx
封	fg	tc
冯	fg	dm
峰	fg	ef
疯	fg	bx
缝	fg	sz
奉	fg	fl
逢	fg	zf
锋	fg	jf
丰	fg	al
凤	fg	jy
蜂	fg	if
枫	fg	mx
俸	fg	rl
沣	fg	df
讽	fg	yx
葑	fg	cc
沨	fg	dx
烽	fg	hf
酆	fg	ee
砜	fg	ux
唪	fg	kl
崶	fg	ec
赗	fg	ko
浲	fg	df
否	fz	bk
缶	fz	wk
负	fu	dr
附	fu	ec
服	fu	oy
副	fu	ad
付	fu	rc
福	fu	pt
府	fu	gc
复	fu	pw
夫	fu	an
富	fu	bt
赴	fu	tb
父	fu	bx
氟	fu	qf
扶	fu	ff
弗	fu	vl
赋	fu	kv
符	fu	vc
斧	fu	bj
伏	fu	rq
幅	fu	jt
敷	fu	fw
芙	fu	cf
傅	fu	rc
釜	fu	ba
腹	fu	ow
浮	fu	dz
辅	fu	if
妇	fu	ne
拂	fu	ff
甫	fu	ad
覆	fu	xw
抚	fu	fw
缚	fu	sc
腐	fu	gr
俘	fu	rz
俯	fu	rc
腑	fu	oc
辐	fu	it
孚	fu	pz
阜	fu	pu
孵	fu	lz
凫	fu	pj
蝠	fu	it
肤	fu	of
芣	fu	cb
祓	fu	pd
脯	fu	of
苻	fu	cc
黼	fu	yf
鄜	fu	ge
馥	fu	hw
涪	fu	dk
桴	fu	mz
黻	fu	yd
麸	fu	ff
拊	fu	fc
郛	fu	pe
莩	fu	cz
玞	fu	wf
簠	fu	vm
绂	fu	sd
宓	fu	bb
跗	fu	zc
茯	fu	cq
赙	fu	kc
趺	fu	zf
茀	fu	cf
蝮	fu	iw
稃	fu	hz
怫	fu	xf
匐	fu	bt
呋	fu	kf
罘	fu	sb
驸	fu	mc
袱	fu	pq
洑	fu	dq
榑	fu	mc
鲋	fu	ac
菔	fu	cy
滏	fu	da
咐	fu	kc
幞	fu	jn
绋	fu	sf
蚨	fu	if
韨	fu	wd
琈	fu	wz
垺	fu	tz
讣	fu	yb
蜉	fu	iz
砆	fu	uf
㕮	fu	kx
㳇	fu	dx
𫓧	fu	jf
𫖯	fu	er
尬	ga	yl
嘎	ga	kg
噶	ga	kv
伽	ga	rk
尕	ga	nx
钆	ga	jv
咖	ga	kk
旮	ga	jo
尜	ga	xx
轧	ga	iv
戛	ga	ag
该	gd	yr
改	gd	jw
盖	gd	ym
钙	gd	jg
概	gd	mv
丐	gd	av
垓	gd	tr
陔	gd	er
溉	gd	dv
赅	gd	kr
荄	gd	cr
戤	gd	ng
晐	gd	or
𬮿	gd	ej
感	gj	xx
干	gj	au
敢	gj	vw
肝	gj	og
杆	gj	mg
赶	gj	tg
甘	gj	na
柑	gj	mg
淦	gj	dj
苷	gj	cg
赣	gj	lr
擀	gj	fg
绀	gj	sg
竿	gj	vg
尴	gj	ym
橄	gj	mw
秆	gj	hg
玕	gj	wg
鳡	gj	ax
酐	gj	yg
矸	gj	ug
疳	gj	bg
泔	gj	dg
坩	gj	tg
旰	gj	og
澉	gj	dw
虷	gj	ig
㽏	gj	dg
刚	gh	kd
岗	gh	ex
港	gh	ds
杠	gh	mg
缸	gh	fg
钢	gh	jx
纲	gh	sx
肛	gh	og
冈	gh	kx
罡	gh	sv
矼	gh	ug
扛	gh	fg
戆	gh	lx
冮	gh	dg
堽	gh	tv
筻	gh	vg
㭎	gh	mx
鿍	gh	tl
高	gc	wk
搞	gc	fk
稿	gc	hk
告	gc	nk
膏	gc	wo
糕	gc	mh
镐	gc	jk
诰	gc	yk
皋	gc	bu
锆	gc	jk
郜	gc	ne
缟	gc	sk
藁	gc	cm
杲	gc	om
篙	gc	vk
睾	gc	pg
槔	gc	mu
羔	gc	yh
槁	gc	mk
筶	gc	vk
个	ge	rl
各	ge	wk
哥	ge	dk
歌	ge	dr
格	ge	mk
割	ge	bd
隔	ge	el
咯	ge	kk
搁	ge	fk
戈	ge	ad
葛	ge	cv
阁	ge	mk
铬	ge	jk
鸽	ge	rn
镉	ge	jl
嗝	ge	kl
革	ge	nl
硌	ge	uk
膈	ge	ol
鬲	ge	al
胳	ge	ok
蛤	ge	ik
骼	ge	gk
舸	ge	vk
圪	ge	tq
疙	ge	bq
饹	ge	uk
滆	ge	dl
袼	ge	pk
哿	ge	lk
仡	ge	rq
合	ge	rk
虼	ge	iq
塥	ge	tl
给	gw	sk
跟	gf	zg
根	gf	mg
哏	gf	kg
艮	gf	en
亘	gf	aa
茛	gf	cg
更	gg	an
梗	gg	mg
羹	gg	yd
耿	gg	eh
耕	gg	lj
庚	gg	gn
埂	gg	tg
哽	gg	kg
赓	gg	gr
暅	gg	oa
鲠	gg	ag
浭	gg	dg
颈	gg	vr
绠	gg	sg
鹒	gg	gn
𬒔	gg	uo
共	gs	cb
供	gs	rb
弓	gs	vv
工	gs	aa
公	gs	bs
宫	gs	bk
攻	gs	gw
功	gs	gl
拱	gs	fb
龚	gs	lb
汞	gs	gu
贡	gs	gr
恭	gs	cx
躬	gs	ug
巩	gs	gf
肱	gs	os
觥	gs	dw
蚣	gs	is
珙	gs	wb
䢼	gs	ce
硔	gs	ub
狗	gz	qk
够	gz	bx
勾	gz	bs
钩	gz	js
沟	gz	ds
购	gz	ks
苟	gz	ck
构	gz	ms
垢	gz	tk
篝	gz	vr
遘	gz	zr
彀	gz	uy
觏	gz	ae
诟	gz	yk
媾	gz	nr
枸	gz	mk
姤	gz	nk
雊	gz	bf
鞲	gz	gr
笱	gz	vk
句	gz	bk
缑	gz	su
佝	gz	rk
岣	gz	ek
耇	gz	lk
故	gu	uw
股	gu	oy
古	gu	uk
鼓	gu	uy
谷	gu	bk
骨	gu	lo
顾	gu	ir
钴	gu	jk
雇	gu	hf
孤	gu	zg
固	gu	kk
菇	gu	ck
蛊	gu	im
姑	gu	nk
箍	gu	vj
估	gu	rk
咕	gu	kk
瞽	gu	uo
沽	gu	dk
菰	gu	cg
诂	gu	yk
辜	gu	uu
毂	gu	uy
觚	gu	dg
榖	gu	uy
贾	gu	xr
酤	gu	yk
锢	gu	jk
崮	gu	ek
堌	gu	tk
蛄	gu	ik
罟	gu	sk
汩	gu	do
鹘	gu	gn
轱	gu	ik
嘏	gu	uy
牯	gu	nk
梏	gu	mk
鲴	gu	ak
呱	gu	kg
鹄	gu	nn
痼	gu	bk
鸪	gu	un
羖	gu	yy
瀔	gu	dy
臌	gu	oy
馉	gu	ug
牿	gu	nk
蓇	gu	cg
𦙶	gu	ok
挂	gx	ft
刮	gx	qd
瓜	gx	pn
卦	gx	tb
寡	gx	bd
剐	gx	kd
胍	gx	og
褂	gx	pb
栝	gx	mk
鸹	gx	qn
诖	gx	yt
怪	gk	xt
乖	gk	qb
拐	gk	fl
夬	gk	vn
掴	gk	fy
管	gr	vk
关	gr	bt
官	gr	bk
观	gr	ye
馆	gr	uk
冠	gr	bc
灌	gr	df
罐	gr	ff
棺	gr	mk
贯	gr	gr
惯	gr	xr
毌	gr	va
倌	gr	rk
掼	gr	fr
琯	gr	wk
瓘	gr	wf
祼	gr	pg
鹳	gr	cn
鳏	gr	ad
筦	gr	ve
爟	gr	hf
盥	gr	pm
涫	gr	dk
纶	gr	sb
莞	gr	ce
鳤	gr	ak
蒄	gr	cc
光	gl	xw
广	gl	di
逛	gl	zw
咣	gl	kw
洸	gl	dw
桄	gl	mw
犷	gl	qg
胱	gl	ow
垙	gl	tw
珖	gl	ww
𨐈	gl	iw
贵	gv	vr
归	gv	le
鬼	gv	ps
柜	gv	mj
跪	gv	zv
轨	gv	ij
硅	gv	ut
龟	gv	dv
圭	gv	tt
桂	gv	mt
规	gv	fe
诡	gv	yv
珪	gv	wt
瑰	gv	wg
癸	gv	vt
簋	gv	vm
妫	gv	nw
鲑	gv	at
邽	gv	te
刿	gv	ed
晷	gv	ok
闺	gv	mt
桧	gv	ms
刽	gv	rd
鳜	gv	ar
鬶	gv	fl
宄	gv	bj
庋	gv	gy
匦	gv	kj
皈	gv	by
炅	gv	oh
姽	gv	nv
筀	gv	vt
滚	gy	dy
棍	gy	mb
鲧	gy	ax
辊	gy	ib
衮	gy	wy
绲	gy	sb
磙	gy	uy
过	go	zc
国	go	ky
锅	go	jn
郭	go	we
果	go	ln
裹	go	wy
粿	go	mg
虢	go	pj
椁	go	mz
馘	go	ba
腘	go	oy
崞	go	ez
馃	go	ug
呙	go	kn
帼	go	jy
蝈	go	iy
聒	go	ek
蜾	go	ig
涡	go	dn
埚	go	tn
𬇹	go	dy
哈	ha	kk
铪	ha	jk
还	hd	zb
海	hd	dm
嗨	hd	km
害	hd	bk
氦	hd	qr
孩	hd	zr
亥	hd	wr
嗐	hd	kk
醢	hd	ym
骇	hd	mr
骸	hd	gr
咳	hd	kr
咍	hd	kk
胲	hd	or
含	hj	rk
喊	hj	kk
韩	hj	uw
汉	hj	dy
汗	hj	dg
寒	hj	bd
函	hj	lk
邯	hj	ge
憨	hj	vx
焊	hj	hg
旱	hj	og
焓	hj	hk
悍	hj	xg
罕	hj	bg
涵	hj	dk
憾	hj	xx
酣	hj	yg
翰	hj	ux
撼	hj	fx
瀚	hj	dx
颔	hj	rr
捍	hj	fg
晗	hj	ok
蚶	hj	ig
鼾	hj	zg
扞	hj	fg
菡	hj	ck
邗	hj	ge
琀	hj	wk
暵	hj	on
顸	hj	gr
撖	hj	fw
浛	hj	dk
㘎	hj	kw
垾	hj	tg
崡	hj	ek
嵅	hj	ek
蔊	hj	cg
行	hh	ii
杭	hh	mj
航	hh	vj
沆	hh	dj
颃	hh	wr
绗	hh	si
巷	hh	cs
吭	hh	kj
好	hc	nz
号	hc	kv
薅	hc	cc
耗	hc	lm
浩	hc	dk
豪	hc	wu
壕	hc	tu
郝	hc	te
嚎	hc	ku
蚝	hc	im
皓	hc	bk
毫	hc	wm
蒿	hc	ck
昊	hc	ot
皞	hc	bu
濠	hc	du
灏	hc	dr
貉	hc	vk
鄗	hc	we
淏	hc	dt
嗥	hc	ku
颢	hc	or
嚆	hc	kk
和	he	hk
喝	he	kv
核	he	mr
盒	he	rm
何	he	rk
河	he	dk
呵	he	kk
赫	he	td
贺	he	lr
鹤	he	dn
禾	he	pm
荷	he	ck
阖	he	mm
龁	he	vq
嗬	he	kk
褐	he	pv
曷	he	ov
颌	he	rr
郃	he	re
盍	he	tm
涸	he	dk
诃	he	yk
鹖	he	on
劾	he	wl
壑	he	lt
纥	he	sq
盉	he	hm
吓	he	kx
龢	he	rh
熇	he	hk
菏	he	ck
饸	he	uk
翮	he	ax
翯	he	xk
阂	he	mr
垎	he	tk
隺	he	df
鞨	he	gv
𬌗	he	yk
黑	hw	lh
嘿	hw	kh
𬭶	hw	jh
很	hf	ig
恨	hf	xg
狠	hf	qg
痕	hf	bg
𬣳	hf	yg
哼	hg	kl
横	hg	mb
恒	hg	xa
衡	hg	ii
亨	hg	wl
珩	hg	wi
桁	hg	mi
蘅	hg	ci
鸻	hg	in
姮	hg	na
堼	hg	tt
红	hs	sg
烘	hs	hb
哄	hs	kb
宏	hs	bs
轰	hs	iy
虹	hs	ig
鸿	hs	dn
洪	hs	db
薨	hs	cb
弘	hs	gs
泓	hs	ds
纮	hs	ss
闳	hs	ms
吽	hs	kn
竑	hs	ls
黉	hs	xb
翃	hs	ux
訇	hs	bk
蕻	hs	cb
唝	hs	kr
讧	hs	yg
荭	hs	cg
玒	hs	wg
谼	hs	bb
𫟹	hs	jb
𬭎	hs	js
后	hz	pk
厚	hz	iz
吼	hz	kv
侯	hz	ru
猴	hz	qu
喉	hz	ku
候	hz	ru
齁	hz	zk
鲎	hz	xa
堠	hz	tu
骺	hz	gk
垕	hz	pt
逅	hz	zk
糇	hz	mu
瘊	hz	bu
篌	hz	vu
郈	hz	pe
鲘	hz	ak
𬭤	hz	ju
壶	hu	uy
户	hu	du
湖	hu	do
胡	hu	uo
虎	hu	hj
乎	hu	pl
糊	hu	mo
互	hu	aa
呼	hu	kh
沪	hu	dh
护	hu	fh
忽	hu	wx
弧	hu	gg
狐	hu	qg
唬	hu	kj
斛	hu	du
瑚	hu	wo
瓠	hu	dg
縠	hu	uy
笏	hu	vw
煳	hu	ho
烀	hu	hh
鄠	hu	ye
葫	hu	co
扈	hu	hb
惚	hu	xx
祜	hu	pk
怙	hu	xk
觳	hu	uy
岵	hu	ek
唿	hu	kx
冱	hu	dh
鹱	hu	ny
鳠	hu	ay
蝴	hu	io
琥	hu	wj
淴	hu	dx
鹕	hu	un
醐	hu	yo
槲	hu	mu
滹	hu	dh
囫	hu	kw
戽	hu	hu
嫭	hu	nh
轷	hu	ih
浒	hu	dw
猢	hu	qo
昈	hu	oh
昒	hu	ow
花	hx	cb
化	hx	rb
画	hx	ak
话	hx	yk
滑	hx	dg
华	hx	ru
划	hx	gd
哗	hx	ku
桦	hx	mu
婳	hx	nk
猾	hx	qg
砉	hx	fu
铧	hx	ju
骅	hx	mu
觟	hx	dt
坏	hk	tb
怀	hk	xb
淮	hk	df
踝	hk	zg
槐	hk	mg
徊	hk	ik
换	hr	fd
环	hr	wb
患	hr	ix
幻	hr	yv
缓	hr	sy
唤	hr	kd
欢	hr	yr
嬛	hr	ny
桓	hr	ma
浣	hr	de
寰	hr	by
獾	hr	qf
焕	hr	hd
涣	hr	dd
洹	hr	da
圜	hr	ky
豢	hr	ju
郇	hr	be
鲩	hr	ae
宦	hr	bi
奂	hr	dd
萑	hr	cf
逭	hr	zk
擐	hr	fy
缳	hr	sy
鹮	hr	sn
澴	hr	dy
镮	hr	jy
漶	hr	dx
鬟	hr	ay
睆	hr	oe
痪	hr	bd
貆	hr	va
峘	hr	ea
锾	hr	jy
㬊	hr	oy
荁	hr	ca
𤩽	hr	wq
𬘫	hr	se
黄	hl	cb
慌	hl	xv
皇	hl	bw
晃	hl	ow
荒	hl	cv
谎	hl	yv
簧	hl	vb
煌	hl	hw
篁	hl	vw
凰	hl	jw
幌	hl	jw
蝗	hl	iw
恍	hl	xw
滉	hl	dw
遑	hl	zw
潢	hl	db
璜	hl	wb
磺	hl	ub
湟	hl	dw
肓	hl	wo
锽	hl	jw
徨	hl	iw
惶	hl	xw
鳇	hl	aw
隍	hl	ew
喤	hl	kw
艎	hl	vw
癀	hl	bb
蟥	hl	ib
媓	hl	nw
瑝	hl	ww
㿠	hl	bw
𨱑	hl	jb
会	hv	rs
回	hv	kk
灰	hv	uh
毁	hv	jy
汇	hv	dk
惠	hv	ax
茴	hv	ck
绘	hv	ss
挥	hv	fi
辉	hv	xi
悔	hv	xm
慧	hv	fx
喙	hv	ku
烩	hv	hs
晖	hv	oi
讳	hv	yw
恢	hv	xh
徽	hv	iw
虺	hv	wi
卉	hv	uc
秽	hv	hx
蕙	hv	cx
麾	hv	gm
诲	hv	ym
晦	hv	om
隳	hv	ex
恚	hv	tx
荟	hv	cs
洄	hv	dk
翚	hv	xi
浍	hv	ds
彗	hv	fe
贿	hv	ko
翙	hv	ex
咴	hv	kh
珲	hv	wi
蛔	hv	ik
哕	hv	kx
诙	hv	yh
袆	hv	pw
橞	hv	mx
蟪	hv	ix
溃	hv	dr
烠	hv	ho
硊	hv	uv
㧑	hv	fw
𬤝	hv	yx
𬭬	hv	je
混	hy	db
魂	hy	eg
婚	hy	no
荤	hy	ci
浑	hy	di
昏	hy	uo
溷	hy	du
阍	hy	mo
馄	hy	ub
诨	hy	yi
惛	hy	xo
碈	hy	uo
或	ho	ga
活	ho	dk
火	ho	dr
货	ho	rr
获	ho	cq
霍	ho	yf
嚯	ho	kf
祸	ho	pn
豁	ho	bk
伙	ho	rh
惑	ho	gx
镬	ho	jy
藿	ho	cf
钬	ho	jh
濩	ho	dy
夥	ho	gx
嚄	ho	ky
蠖	ho	iy
攉	ho	ff
漷	ho	de
劐	ho	cd
耠	ho	lk
佸	ho	rk
锪	ho	jx
㸌	ho	hf
𬴃	ho	mu
及	ji	pn
即	ji	ge
级	ji	sj
机	ji	mj
既	ji	gv
集	ji	rm
记	ji	yj
鸡	ji	yn
极	ji	mj
几	ji	pv
季	ji	hz
肌	ji	oj
基	ji	qt
急	ji	dx
系	ji	px
挤	ji	fl
继	ji	sv
剂	ji	wd
计	ji	yu
姬	ji	nl
寄	ji	bk
技	ji	fy
祭	ji	px
吉	ji	uk
寂	ji	by
击	ji	ak
籍	ji	vo
忌	ji	jx
纪	ji	sj
己	ji	vv
积	ji	hb
暨	ji	ga
箕	ji	vb
疾	ji	bu
脊	ji	do
辑	ji	ie
戟	ji	ug
激	ji	dw
济	ji	dl
矶	ji	uj
叽	ji	kj
迹	ji	zd
饥	ji	uj
棘	ji	an
绩	ji	sr
冀	ji	lb
藉	ji	co
蓟	ji	cd
际	ji	ex
妓	ji	ny
稷	ji	hw
汲	ji	dj
霁	ji	yl
亟	ji	la
伋	ji	rj
赍	ji	ur
髻	ji	ak
鲫	ji	ae
殛	ji	da
稽	ji	ho
奇	ji	dk
伎	ji	ry
嵴	ji	eo
偈	ji	rv
畸	ji	tk
圾	ji	tj
嫉	ji	nu
讥	ji	yj
笈	ji	vj
罽	ji	sd
唧	ji	ke
齑	ji	wl
乩	ji	lv
骥	ji	mb
芰	ji	cy
畿	ji	yt
戢	ji	ka
玑	ji	wj
笄	ji	vk
嵇	ji	he
洎	ji	dz
楫	ji	me
垍	ji	tz
麂	ji	gj
羁	ji	sm
跻	ji	zl
跽	ji	zx
屐	ji	uy
蕺	ji	ca
姞	ji	nk
荠	ji	cl
觊	ji	ee
漈	ji	dx
缉	ji	se
悸	ji	xz
鲚	ji	al
剞	ji	dd
觭	ji	dk
佶	ji	rk
掎	ji	fk
岌	ji	ej
惎	ji	qx
耤	ji	lo
芨	ji	cj
虮	ji	ij
瘠	ji	bo
期	ji	qo
蹐	ji	zo
犄	ji	nk
穄	ji	hx
堲	ji	gt
蒺	ji	cu
墼	ji	it
瀱	ji	dd
鹡	ji	dn
鱾	ji	aj
㴔	ji	dx
徛	ji	ik
枅	ji	mk
𪟝	ji	fl
𫌀	ji	pr
𫓯	ji	jt
𫓹	ji	jb
𬯀	ji	el
𬶨	ji	ga
𬶭	ji	ax
加	jx	lk
家	jx	bu
假	jx	ry
价	jx	rl
甲	jx	ll
架	jx	lm
夹	jx	an
嫁	jx	nu
钾	jx	jj
佳	jx	rt
嘉	jx	uk
迦	jx	zk
驾	jx	lm
镓	jx	ju
痂	jx	bk
颊	jx	jr
荚	jx	cj
枷	jx	mk
葭	jx	cy
岬	jx	ej
珈	jx	wk
斝	jx	ku
笳	jx	vk
郏	jx	je
瘕	jx	by
铗	jx	jj
稼	jx	hu
浃	jx	dj
茄	jx	ck
胛	jx	oj
槚	jx	mr
跏	jx	zk
蛱	jx	ij
袈	jx	ly
恝	jx	fx
泇	jx	dk
𬂩	jx	mj
间	jm	mo
见	jm	ke
剑	jm	rd
件	jm	rn
键	jm	jz
兼	jm	bn
减	jm	dk
建	jm	zy
煎	jm	bh
捡	jm	fa
箭	jm	vd
剪	jm	bd
肩	jm	ho
简	jm	vo
尖	jm	xd
舰	jm	ve
贱	jm	kj
碱	jm	uk
健	jm	rz
歼	jm	dq
茧	jm	ci
监	jm	lm
荐	jm	cz
溅	jm	dj
渐	jm	dj
拣	jm	fd
检	jm	ma
谏	jm	yj
僭	jm	ro
奸	jm	ng
坚	jm	lt
鉴	jm	lj
笺	jm	vj
蹇	jm	br
涧	jm	do
践	jm	zj
睑	jm	oa
菅	jm	ck
艰	jm	yg
翦	jm	bx
俭	jm	ra
腱	jm	oz
柬	jm	an
缄	jm	sk
笕	jm	ve
缣	jm	sn
锏	jm	jo
戋	jm	ad
鞬	jm	gz
謇	jm	bk
湔	jm	dd
犍	jm	nz
踺	jm	zz
裥	jm	po
槛	jm	mm
篯	jm	vj
蒹	jm	cn
搛	jm	fn
鲣	jm	at
戬	jm	yg
鹣	jm	bn
楗	jm	mz
暕	jm	oj
枧	jm	me
谫	jm	yd
毽	jm	mz
趼	jm	zk
饯	jm	uj
鞯	jm	gz
牮	jm	rn
鳒	jm	an
𬣡	jm	yj
将	jl	dc
讲	jl	yj
奖	jl	dd
酱	jl	dy
姜	jl	yn
江	jl	dg
降	jl	el
蒋	jl	cc
僵	jl	ra
匠	jl	kj
桨	jl	dm
浆	jl	du
绛	jl	sl
犟	jl	gn
疆	jl	ga
缰	jl	sa
鳉	jl	ac
豇	jl	ag
洚	jl	dl
强	jl	gi
耩	jl	lr
弶	jl	gx
糨	jl	mi
礓	jl	ua
茳	jl	cg
膙	jl	oi
叫	jn	kl
交	jn	wx
较	jn	ix
教	jn	lw
脚	jn	oe
角	jn	dy
胶	jn	ox
浇	jn	dw
焦	jn	rh
缴	jn	sw
搅	jn	fe
嚼	jn	kc
椒	jn	my
窖	jn	bk
鲛	jn	ax
娇	jn	nl
绞	jn	sx
跤	jn	zx
轿	jn	il
矫	jn	ul
剿	jn	vd
蛟	jn	ix
骄	jn	ml
徼	jn	iw
礁	jn	uh
饺	jn	ux
蕉	jn	ch
铰	jn	jx
狡	jn	qx
皎	jn	bx
郊	jn	we
湫	jn	dh
酵	jn	yz
滘	jn	dk
校	jn	mx
姣	jn	nx
鹪	jn	rn
醮	jn	yh
皦	jn	bw
觉	jn	xe
敫	jn	bw
艽	jn	cj
茭	jn	cx
峤	jn	el
佼	jn	rx
璬	jn	ww
燋	jn	hh
侥	jn	rw
斠	jn	au
皭	jn	bc
峧	jn	ex
藠	jn	cb
噍	jn	kh
漖	jn	dw
僬	jn	rh
恔	jn	xx
䴔	jn	wn
届	jp	uy
界	jp	tl
借	jp	ro
接	jp	fn
皆	jp	bb
解	jp	dn
节	jp	ce
姐	jp	nq
街	jp	ii
结	jp	sk
截	jp	uf
杰	jp	mh
劫	jp	tl
戒	jp	gc
阶	jp	el
揭	jp	fv
介	jp	rl
蚧	jp	il
捷	jp	fr
洁	jp	dk
芥	jp	cl
嗟	jp	kg
桀	jp	xm
诘	jp	yk
羯	jp	yv
竭	jp	lv
桔	jp	mk
颉	jp	ur
孑	jp	va
疖	jp	be
诫	jp	yc
玠	jp	wl
碣	jp	uv
婕	jp	nr
疥	jp	bl
睫	jp	or
絜	jp	fx
劼	jp	ul
秸	jp	hk
拮	jp	fk
檞	jp	mn
骱	jp	gl
湝	jp	db
蜐	jp	il
鲒	jp	ak
楷	jp	mb
讦	jp	yg
喈	jp	kb
悈	jp	xc
褯	jp	pj
岊	jp	be
㛃	jp	fn
进	jb	zj
近	jb	zj
仅	jb	ry
金	jb	ra
斤	jb	pl
今	jb	rv
尽	jb	id
劲	jb	vl
紧	jb	lx
晋	jb	yo
筋	jb	vl
禁	jb	mx
锦	jb	jj
津	jb	dy
巾	jb	ll
浸	jb	dy
堇	jb	na
谨	jb	ya
靳	jb	gj
槿	jb	ma
瑾	jb	wa
矜	jb	sv
衿	jb	pv
烬	jb	hd
襟	jb	px
瑨	jb	wo
噤	jb	kx
溍	jb	do
缙	jb	so
觐	jb	ne
祲	jb	py
妗	jb	nv
馑	jb	ua
浕	jb	dd
赆	jb	kd
荩	jb	cd
殣	jb	da
珒	jb	wy
廑	jb	ga
琎	jb	wz
墐	jb	ta
卺	jb	lv
𬬱	jb	jj
经	jk	sg
竟	jk	le
精	jk	mo
镜	jk	je
净	jk	dl
静	jk	fl
竞	jk	le
景	jk	ox
京	jk	wx
敬	jk	cw
井	jk	al
鲸	jk	ax
惊	jk	xx
警	jk	ck
境	jk	te
茎	jk	cg
径	jk	ig
荆	jk	cd
靖	jk	lo
菁	jk	co
晶	jk	oo
睛	jk	oo
璟	jk	wx
胫	jk	og
粳	jk	mg
肼	jk	oj
阱	jk	ej
旌	jk	fu
泾	jk	dg
丼	jk	jd
婧	jk	no
竫	jk	ll
迳	jk	zg
腈	jk	oo
儆	jk	rw
憬	jk	xx
痉	jk	bg
倞	jk	rx
刭	jk	vd
靓	jk	fe
獍	jk	qe
兢	jk	ue
鼱	jk	jo
汫	jk	dj
璥	jk	ww
麖	jk	gx
猄	jk	qx
䴖	jk	fn
囧	js	kv
冏	js	kk
迥	js	zk
炯	js	hk
窘	js	bk
扃	js	hk
颎	js	br
坰	js	tk
泂	js	dk
䌹	js	sk
𬳶	js	mk
就	jq	wy
酒	jq	dy
旧	jq	lo
救	jq	qw
九	jq	pv
久	jq	pn
揪	jq	fh
鸠	jq	jn
灸	jq	jh
啾	jq	kh
玖	jq	wj
韭	jq	fa
纠	jq	sl
舅	jq	jl
究	jq	bj
咎	jq	wk
臼	jq	pa
鹫	jq	wn
厩	jq	iv
僦	jq	ry
柩	jq	mj
疚	jq	bj
氿	jq	dj
鬏	jq	ah
阄	jq	mv
赳	jq	tl
桕	jq	mj
㠇	jq	ey
据	ju	fk
剧	ju	ud
局	ju	uk
举	ju	xl
距	ju	zj
聚	ju	en
巨	ju	ka
居	ju	uk
狙	ju	qq
具	ju	qb
拒	ju	fj
菊	ju	cm
俱	ju	rb
锯	ju	jk
焗	ju	hk
橘	ju	mk
惧	ju	xb
矩	ju	uj
車	ju	al
钜	ju	jj
鞠	ju	gm
遽	ju	zu
拘	ju	fk
沮	ju	dq
莒	ju	ck
驹	ju	mk
掬	ju	fm
踞	ju	zk
锔	ju	jk
苴	ju	cq
炬	ju	hj
琚	ju	wk
讵	ju	yj
咀	ju	kq
裾	ju	pk
鞫	ju	gk
椐	ju	mk
秬	ju	hj
屦	ju	un
倨	ju	rk
雎	ju	qf
苣	ju	cj
娵	ju	ny
疽	ju	bq
榉	ju	ml
筥	ju	vk
蒟	ju	ck
窭	ju	bn
砠	ju	uq
醵	ju	yu
龃	ju	vq
崌	ju	ek
泃	ju	dk
踽	ju	zy
犋	ju	nb
岨	ju	eq
趄	ju	tq
澽	ju	du
飓	ju	jb
岠	ju	ej
腒	ju	ok
弆	ju	tc
䴗	ju	on
𬶋	ju	ak
卷	jr	jv
捐	jr	fo
圈	jr	kv
绢	jr	so
涓	jr	do
娟	jr	no
倦	jr	rv
隽	jr	rn
狷	jr	qo
镌	jr	jn
蠲	jr	bi
鹃	jr	kn
鄄	jr	xe
眷	jr	jo
焆	jr	ho
锩	jr	jv
桊	jr	jm
绝	jt	sb
决	jt	dg
撅	jt	fr
爵	jt	pc
倔	jt	ri
掘	jt	fi
厥	jt	ir
诀	jt	yg
蕨	jt	cr
玦	jt	wg
蹶	jt	zr
噘	jt	kr
崛	jt	ei
攫	jt	fy
珏	jt	wy
谲	jt	yk
橛	jt	mr
抉	jt	fg
傕	jt	rf
玃	jt	qy
爝	jt	hc
孓	jt	vn
桷	jt	my
觖	jt	dg
矍	jt	oy
獗	jt	qr
镢	jt	jr
劂	jt	id
砄	jt	ug
㵐	jt	dr
𫔎	jt	jk
𫘝	jt	mg
均	jy	td
君	jy	yk
军	jy	bi
郡	jy	ye
菌	jy	ch
俊	jy	rw
峻	jy	ew
钧	jy	jd
骏	jy	mw
浚	jy	dw
畯	jy	tw
珺	jy	wk
麇	jy	gh
竣	jy	lw
焌	jy	hw
皲	jy	by
晙	jy	ow
莙	jy	ck
葰	jy	cw
捃	jy	fk
筠	jy	vd
鲪	jy	ak
䐃	jy	oh
卡	ka	ub
咔	ka	kb
喀	ka	kk
胩	ka	ob
开	kd	ac
凯	kd	ej
铠	kd	jj
恺	kd	xj
揩	kd	fb
锎	kd	jk
闿	kd	mj
慨	kd	xv
锴	kd	jb
垲	kd	tj
忾	kd	xq
炌	kd	hl
剀	kd	ed
蒈	kd	cb
看	kj	uo
砍	kj	ur
坎	kj	tr
刊	kj	gd
堪	kj	tv
侃	kj	rv
勘	kj	ql
龛	kj	rl
阚	kj	mw
莰	kj	cr
瞰	kj	ow
戡	kj	qg
衎	kj	ii
磡	kj	ul
崁	kj	er
嵁	kj	ev
墈	kj	tl
抗	kh	fj
康	kh	gn
炕	kh	hj
糠	kh	mn
钪	kh	jj
慷	kh	xn
亢	kh	wj
伉	kh	rj
闶	kh	mj
𡐓	kh	tn
𩾌	kh	an
靠	kc	nf
考	kc	lv
烤	kc	hv
拷	kc	fv
尻	kc	uj
铐	kc	jv
犒	kc	nk
栲	kc	mv
洘	kc	dv
㸆	kc	hf
可	ke	dk
课	ke	yg
克	ke	ue
科	ke	hu
客	ke	bk
氪	ke	qe
颗	ke	gr
壳	ke	uj
磕	ke	um
刻	ke	wd
柯	ke	mk
嗑	ke	km
珂	ke	wk
渴	ke	dv
棵	ke	mg
恪	ke	xk
颏	ke	wr
髁	ke	gg
苛	ke	ck
窠	ke	bg
轲	ke	ik
蝌	ke	iu
疴	ke	bk
瞌	ke	om
坷	ke	tk
缂	ke	sg
锞	ke	jg
骒	ke	mg
炣	ke	hk
岢	ke	ek
稞	ke	hg
匼	ke	kk
溘	ke	dm
牁	ke	pk
剋	kw	ud
啃	kf	ko
肯	kf	vo
垦	kf	gt
恳	kf	gx
裉	kf	pg
坑	kg	tj
铿	kg	jt
硁	kg	ug
空	ks	bg
孔	ks	zv
控	ks	fg
恐	ks	gx
崆	ks	eg
硿	ks	ug
箜	ks	vg
倥	ks	rg
埪	ks	tg
口	kz	la
扣	kz	fk
抠	kz	fx
寇	kz	by
叩	kz	ke
蔻	kz	cy
芤	kz	cv
筘	kz	vk
眍	kz	ox
𫸩	kz	gx
库	ku	gi
哭	ku	kq
苦	ku	ck
酷	ku	yk
裤	ku	pi
枯	ku	mk
窟	ku	bi
喾	ku	xk
刳	ku	dd
骷	ku	gk
绔	ku	sk
矻	ku	uq
圐	ku	kf
跨	kx	zk
夸	kx	dk
垮	kx	tk
胯	kx	ok
挎	kx	fk
侉	kx	rk
姱	kx	nk
快	kk	xg
块	kk	tg
筷	kk	vg
哙	kk	ks
脍	kk	os
郐	kk	re
侩	kk	rs
蒯	kk	cd
鲙	kk	as
狯	kk	qs
㧟	kk	fk
款	kr	ur
宽	kr	be
髋	kr	ge
狂	kl	qw
框	kl	mw
矿	kl	ug
筐	kl	vw
况	kl	de
哐	kl	kw
旷	kl	og
眶	kl	ow
匡	kl	kw
诓	kl	yw
邝	kl	ge
诳	kl	yw
圹	kl	tg
贶	kl	ke
纩	kl	sg
夼	kl	di
洭	kl	dw
𫛭	kl	qn
亏	kv	ev
奎	kv	dt
窥	kv	be
蝰	kv	it
盔	kv	um
夔	kv	bw
葵	kv	ct
魁	kv	gu
匮	kv	kr
愧	kv	xg
揆	kv	ft
馈	kv	ur
喹	kv	kt
逵	kv	zt
愦	kv	xr
傀	kv	rg
睽	kv	ot
骙	kv	mt
櫆	kv	mu
馗	kv	jz
聩	kv	er
跬	kv	zt
煃	kv	ht
悝	kv	xl
戣	kv	vg
喟	kv	ko
蒉	kv	cr
篑	kv	vr
岿	kv	ee
暌	kv	ot
𫠆	kv	ur
困	ky	km
坤	ky	tu
捆	ky	fm
昆	ky	ob
鲲	ky	ab
堃	ky	ft
髡	ky	aw
醌	ky	yb
琨	ky	wb
鹍	ky	on
焜	ky	hb
阃	ky	mm
悃	ky	xm
锟	ky	jb
壸	ky	uy
裈	ky	pi
婫	ky	nb
扩	ko	fg
阔	ko	mk
括	ko	fk
廓	ko	ge
蛞	ko	ik
啦	la	kl
拉	la	fl
辣	la	lu
剌	la	ud
蜡	la	io
菈	la	cl
腊	la	oo
喇	la	kd
垃	la	tl
落	la	ck
邋	la	zv
镴	la	jv
旯	la	oj
蝲	la	id
揦	la	
瘌	la	bd
砬	la	ul
鞡	la	gl
𬶟	la	ad
来	ld	an
莱	ld	cl
赖	ld	ur
铼	ld	jl
濑	ld	dr
赉	ld	lr
徕	ld	il
癞	ld	br
睐	ld	ol
涞	ld	dl
崃	ld	el
籁	ld	vr
俫	ld	rl
梾	ld	ml
烂	lj	hs
蓝	lj	cm
懒	lj	xr
兰	lj	bs
栏	lj	ms
揽	lj	fe
拦	lj	fs
篮	lj	vm
岚	lj	ex
滥	lj	dm
览	lj	le
澜	lj	dj
榄	lj	me
阑	lj	mj
镧	lj	jj
缆	lj	se
婪	lj	mn
褴	lj	pm
斓	lj	wj
谰	lj	yj
罱	lj	sg
襕	lj	pj
漤	lj	dn
𬒗	lj	ue
狼	lh	ql
浪	lh	dl
郎	lh	de
朗	lh	do
廊	lh	ge
啷	lh	ke
琅	lh	wl
烺	lh	hl
螂	lh	ie
崀	lh	el
阆	lh	ml
锒	lh	jl
榔	lh	me
桹	lh	ml
埌	lh	tl
塱	lh	dt
莨	lh	cl
蒗	lh	cl
稂	lh	hl
筤	lh	vl
㫰	lh	ol
㮾	lh	dm
蓢	lh	co
老	lc	lb
捞	lc	fl
佬	lc	rb
唠	lc	kl
劳	lc	cl
牢	lc	bn
烙	lc	hk
铑	lc	jb
姥	lc	nb
涝	lc	dl
醪	lc	yp
酪	lc	yk
痨	lc	bl
铹	lc	jl
嫪	lc	np
崂	lc	el
栳	lc	mb
荖	lc	cb
络	lc	sk
耢	lc	ll
𫭼	lc	tl
了	le	vl
乐	le	pd
勒	le	gl
叻	le	kl
仂	le	rl
鳓	le	al
簕	le	vl
泐	le	dl
嘞	le	kl
类	lw	md
累	lw	tx
雷	lw	yt
泪	lw	do
蕾	lw	ct
垒	lw	st
镭	lw	jt
肋	lw	ol
磊	lw	uu
擂	lw	ft
罍	lw	tf
酹	lw	yc
羸	lw	wf
诔	lw	yl
耒	lw	fn
藟	lw	ct
嫘	lw	nx
缧	lw	sx
儡	lw	rt
檑	lw	mt
礌	lw	ut
癗	lw	bt
冷	lg	ds
楞	lg	mf
愣	lg	xf
棱	lg	mw
崚	lg	ew
塄	lg	tf
堎	lg	tw
里	li	la
离	li	wd
力	li	vp
李	li	mz
例	li	rd
利	li	hd
理	li	wl
立	li	wa
礼	li	pv
粒	li	ml
梨	li	hm
锂	li	jl
历	li	il
丽	li	ad
哩	li	kl
黎	li	hu
栗	li	xm
璃	li	wd
莉	li	cd
吏	li	an
戾	li	hq
鲤	li	al
藜	li	cu
笠	li	vl
厘	li	il
犁	li	hn
厉	li	iw
狸	li	ql
隶	li	vn
栎	li	ml
骊	li	ml
俪	li	rl
荔	li	cl
澧	li	da
沥	li	dl
励	li	il
醴	li	ya
砾	li	ul
砺	li	uw
詈	li	sk
痢	li	bd
罹	li	sf
疠	li	bw
莅	li	cl
鳢	li	aa
俚	li	rl
篱	li	vd
郦	li	le
喱	li	kl
漓	li	dd
浬	li	dl
轹	li	il
俐	li	rd
蓠	li	cd
蛎	li	iw
蠡	li	vi
枥	li	ml
唳	li	kq
呖	li	kl
溧	li	dm
蜊	li	id
鲡	li	al
醨	li	yd
嫠	li	wn
凓	li	dm
逦	li	zl
苈	li	cl
娌	li	nl
粝	li	mw
鹂	li	ln
黧	li	hh
缡	li	sd
傈	li	rm
坜	li	tl
疬	li	bl
跞	li	zl
朸	li	ml
珕	li	wl
浰	li	dd
雳	li	yl
猁	li	qd
篥	li	vm
㰀	li	mu
𫵷	li	el
𬍛	li	wl
俩	lx	rl
连	lm	zi
练	lm	sd
脸	lm	oa
链	lm	jz
联	lm	et
恋	lm	wx
莲	lm	cz
帘	lm	bj
炼	lm	hd
镰	lm	jn
敛	lm	rw
怜	lm	xs
廉	lm	gn
濂	lm	dn
涟	lm	dz
殓	lm	da
蠊	lm	in
琏	lm	wz
鲢	lm	az
楝	lm	mj
奁	lm	dx
蔹	lm	cw
梿	lm	mz
裢	lm	pz
潋	lm	dw
裣	lm	pa
瑓	lm	wj
𬶠	lm	aj
量	ll	ol
两	ll	ad
亮	ll	wj
梁	ll	dm
辆	ll	il
凉	ll	dx
粮	ll	ml
良	ll	dg
晾	ll	ox
谅	ll	yx
粱	ll	dm
椋	ll	mx
俍	ll	rl
魉	ll	gl
墚	ll	tm
踉	ll	zl
辌	ll	ix
悢	ll	xl
𫟅	ll	sx
𬜯	ll	cl
聊	ln	ee
撩	ln	fx
料	ln	mu
辽	ln	zl
廖	ln	gp
寮	ln	bx
撂	ln	fk
疗	ln	bl
蓼	ln	cp
瞭	ln	ox
钌	ln	jl
燎	ln	hx
獠	ln	qx
潦	ln	dx
僚	ln	rx
憭	ln	xx
髎	ln	gp
寥	ln	bp
嘹	ln	kx
橑	ln	mx
嫽	ln	nx
缭	ln	sx
镣	ln	jx
尥	ln	yu
蹽	ln	zx
漻	ln	dp
鹩	ln	dn
簝	ln	vx
𪤗	ln	tp
列	lp	dd
咧	lp	kd
猎	lp	qo
烈	lp	dh
裂	lp	dy
劣	lp	ul
鬣	lp	av
洌	lp	dd
捩	lp	fq
冽	lp	dd
埒	lp	tc
躐	lp	zv
趔	lp	td
峛	lp	ed
脟	lp	oc
䴕	lp	dn
𫚭	lp	av
林	lb	mm
拎	lb	fs
临	lb	la
磷	lb	ul
凛	lb	dx
淋	lb	dm
琳	lb	wm
鳞	lb	al
邻	lb	re
麟	lb	gl
璘	lb	wl
啉	lb	km
霖	lb	ym
廪	lb	gx
赁	lb	rr
膦	lb	ol
蔺	lb	cf
吝	lb	wk
檩	lb	mx
懔	lb	xx
潾	lb	dl
粼	lb	mv
嶙	lb	el
躏	lb	zf
遴	lb	zl
辚	lb	il
箖	lb	vm
瞵	lb	ol
翷	lb	mx
𬭸	lb	jl
𬴊	lb	ml
令	lk	rs
另	lk	kl
零	lk	ys
领	lk	rr
铃	lk	js
灵	lk	eh
玲	lk	ws
岭	lk	es
陵	lk	ew
凌	lk	dw
绫	lk	sw
龄	lk	vs
翎	lk	rx
泠	lk	ds
聆	lk	es
澪	lk	ds
伶	lk	rs
菱	lk	cw
蛉	lk	is
苓	lk	cs
姈	lk	ns
呤	lk	ks
羚	lk	ys
瓴	lk	rw
棂	lk	mh
祾	lk	pw
鲮	lk	aw
舲	lk	vs
酃	lk	ye
坽	lk	ts
囹	lk	ks
柃	lk	ms
〇	lk	vv
鸰	lk	rn
昤	lk	os
㥄	lk	xw
六	lq	wb
留	lq	pt
流	lq	dv
刘	lq	wd
溜	lq	dt
柳	lq	me
硫	lq	uv
瘤	lq	bt
遛	lq	zt
镠	lq	jp
琉	lq	wv
熘	lq	ht
浏	lq	dd
绺	lq	sk
榴	lq	mt
旒	lq	fv
陆	lq	ej
鎏	lq	dj
骝	lq	mt
馏	lq	ut
镏	lq	jt
锍	lq	jv
珋	lq	we
疁	lq	tp
罶	lq	st
鹨	lq	xn
瑬	lq	dy
飗	lq	jt
碌	lq	uu
鹠	lq	pn
龙	ls	ud
隆	ls	eu
笼	ls	vl
泷	ls	dl
拢	ls	fl
陇	ls	el
聋	ls	le
胧	ls	ol
珑	ls	wl
垄	ls	lt
栊	ls	ml
茏	ls	cl
砻	ls	lu
咙	ls	kl
哢	ls	kc
癃	ls	bu
窿	ls	bu
昽	ls	ol
弄	ls	wc
漋	ls	du
眬	ls	ol
𬕂	ls	vr
楼	lz	mn
喽	lz	kn
漏	lz	dy
搂	lz	fn
娄	lz	mn
瘘	lz	bn
露	lz	yk
镂	lz	jn
篓	lz	vn
陋	lz	ev
蒌	lz	cn
耧	lz	ln
蝼	lz	in
偻	lz	rn
溇	lz	dn
髅	lz	gn
嵝	lz	en
䁖	lz	on
剅	lz	ad
𦝼	lz	on
𪣻	lz	tn
路	lu	zk
录	lu	eu
撸	lu	fo
鲁	lu	ao
鹿	lu	gb
卢	lu	lu
卤	lu	lx
炉	lu	hh
虏	lu	hl
噜	lu	ko
麓	lu	mb
掳	lu	fl
戮	lu	xg
禄	lu	pu
庐	lu	gh
橹	lu	mo
垆	lu	tu
颅	lu	lr
芦	lu	ch
璐	lu	wk
鹭	lu	zn
泸	lu	du
潞	lu	dk
胪	lu	ou
渌	lu	du
镥	lu	jo
赂	lu	kk
鲈	lu	au
菉	lu	cu
簏	lu	vb
蕗	lu	ck
漉	lu	db
辂	lu	ik
僇	lu	rp
箓	lu	vu
栌	lu	mu
舻	lu	vu
琭	lu	wu
辘	lu	ib
逯	lu	zu
鸬	lu	ln
甪	lu	py
绿	lu	su
轳	lu	iu
勠	lu	xl
澛	lu	do
氇	lu	mo
稑	lu	ht
𫘧	lu	mu
𬬻	lu	ju
乱	lr	qv
卵	lr	pd
鸾	lr	wn
栾	lr	wm
銮	lr	wj
娈	lr	wn
挛	lr	wu
峦	lr	we
脔	lr	wr
孪	lr	wz
滦	lr	dm
论	ly	yb
轮	ly	ib
抡	ly	fb
伦	ly	rb
仑	ly	rb
沦	ly	db
囵	ly	kb
𫭢	ly	tb
𬬭	ly	jb
罗	lo	sx
洛	lo	dk
裸	lo	pg
啰	lo	kx
摞	lo	fx
骆	lo	mk
螺	lo	ix
骡	lo	mx
萝	lo	cx
锣	lo	jx
雒	lo	wf
珞	lo	wk
逻	lo	zx
蠃	lo	wf
箩	lo	vx
泺	lo	dl
荦	lo	cn
漯	lo	dx
捋	lo	fc
倮	lo	rg
椤	lo	mx
瘰	lo	bx
猡	lo	qx
蓏	lo	cg
脶	lo	on
率	lv	wu
铝	lv	jk
吕	lv	kk
驴	lv	mh
律	lv	iy
旅	lv	fn
氯	lv	qu
屡	lv	un
滤	lv	dx
虑	lv	hx
履	lv	uw
缕	lv	sn
侣	lv	rk
闾	lv	mk
膂	lv	fo
梠	lv	mk
榈	lv	mk
褛	lv	pn
稆	lv	hk
葎	lv	cy
垏	lv	ty
略	lt	tk
掠	lt	fx
锊	lt	jc
圙	lt	km
䂮	lt	fu
吗	ma	km
嘛	ma	km
骂	ma	km
马	ma	va
码	ma	um
妈	ma	nm
麻	ma	gm
玛	ma	wm
蚂	ma	im
抹	ma	fm
蟆	ma	id
祃	ma	pm
犸	ma	qm
摩	ma	gu
杩	ma	mm
买	md	vd
卖	md	ud
麦	md	fw
埋	md	tl
迈	md	zw
脉	md	oy
霾	md	yl
唛	md	kw
劢	md	wl
荬	md	cd
鿏	md	jw
慢	mj	xy
满	mj	dl
蛮	mj	wi
曼	mj	oy
漫	mj	dy
螨	mj	il
瞒	mj	ol
蔓	mj	cy
幔	mj	jy
鳗	mj	ay
缦	mj	sy
馒	mj	uy
谩	mj	yy
鬘	mj	ay
墁	mj	ty
嫚	mj	ny
镘	mj	jy
颟	mj	cr
鞔	mj	gv
𬜬	mj	ck
忙	mh	xw
盲	mh	wo
莽	mh	cc
芒	mh	cw
氓	mh	wm
蟒	mh	ic
茫	mh	cw
邙	mh	we
漭	mh	dc
尨	mh	ud
杧	mh	mw
牻	mh	nd
牤	mh	nw
厖	mh	id
硭	mh	uw
猫	mc	qt
毛	mc	pv
冒	mc	ko
帽	mc	jo
锚	mc	jt
贸	mc	pr
矛	mc	sp
茅	mc	cp
卯	mc	pe
貌	mc	ve
昴	mc	oe
茂	mc	cw
冇	mc	uk
旄	mc	fm
峁	mc	ee
髦	mc	am
铆	mc	je
耄	mc	lm
楙	mc	mm
懋	mc	mx
芼	mc	cm
瑁	mc	wo
牦	mc	nm
茆	mc	ce
袤	mc	wy
瞀	mc	so
泖	mc	de
蝥	mc	si
眊	mc	om
鄚	mc	ce
蟊	mc	si
么	me	ps
没	mw	dy
每	mw	pm
美	mw	yd
枚	mw	mw
梅	mw	mm
酶	mw	ym
妹	mw	nw
镁	mw	jd
煤	mw	hm
霉	mw	ym
眉	mw	vo
魅	mw	gw
玫	mw	ww
媚	mw	no
媒	mw	nm
昧	mw	ow
莓	mw	cm
郿	mw	ve
镅	mw	jo
寐	mw	bw
湄	mw	do
浼	mw	dv
袂	mw	pg
楣	mw	mo
鹛	mw	vn
渼	mw	dd
瑂	mw	wo
糜	mw	gm
媄	mw	nd
嵋	mw	eo
们	mf	rm
门	mf	dv
焖	mf	hx
闷	mf	mx
扪	mf	fm
钔	mf	jm
呇	mf	uk
懑	mf	dx
𫞩	mf	wl
梦	mg	mx
猛	mg	qm
萌	mg	co
蒙	mg	cu
懵	mg	xo
孟	mg	zm
锰	mg	jm
盟	mg	om
濛	mg	du
獴	mg	qu
勐	mg	zl
虻	mg	iw
檬	mg	mu
蠓	mg	iu
甍	mg	cw
艋	mg	vm
朦	mg	ou
瞢	mg	co
幪	mg	ju
艨	mg	vu
蜢	mg	im
礞	mg	un
㠓	mg	eu
鹲	mg	cn
𫑡	mg	ke
米	mi	dm
迷	mi	zm
密	mi	be
谜	mi	yz
蜜	mi	bi
咪	mi	km
弥	mi	gx
觅	mi	pe
幂	mi	bj
蘼	mi	cf
芈	mi	ll
靡	mi	gf
醚	mi	yz
眯	mi	om
祕	mi	pb
祢	mi	px
弭	mi	ge
麋	mi	gm
汨	mi	do
蓂	mi	cb
脒	mi	om
谧	mi	ym
醾	mi	ym
縻	mi	gx
猕	mi	qx
敉	mi	mw
洣	mi	dm
嘧	mi	ke
面	mm	aa
免	mm	dv
棉	mm	mj
眠	mm	om
缅	mm	sm
绵	mm	sj
勉	mm	dl
冕	mm	kv
沔	mm	dm
眄	mm	om
丏	mm	av
勔	mm	ml
愐	mm	xm
娩	mm	nv
湎	mm	dm
腼	mm	om
偭	mm	rm
渑	mm	dd
𩾃	mm	av
秒	mn	hu
喵	mn	kt
瞄	mn	ot
庙	mn	gy
妙	mn	nu
苗	mn	ct
描	mn	ft
淼	mn	uu
渺	mn	du
眇	mn	ou
缈	mn	su
杪	mn	mu
邈	mn	ze
藐	mn	ce
缪	mn	sp
鹋	mn	cn
灭	mp	ah
咩	mp	ky
乜	mp	vv
蔑	mp	cu
篾	mp	vu
民	mb	vv
敏	mb	pw
抿	mb	fm
皿	mb	la
闽	mb	mi
泯	mb	dm
闵	mb	mw
旻	mb	ow
缗	mb	so
愍	mb	mx
岷	mb	em
湣	mb	do
珉	mb	wm
悯	mb	xw
鳘	mb	pa
黾	mb	kd
忞	mb	wx
苠	mb	cm
名	mk	xk
命	mk	re
明	mk	oo
鸣	mk	kn
茗	mk	ck
冥	mk	bb
铭	mk	jk
暝	mk	ob
洺	mk	dk
溟	mk	db
瞑	mk	ob
螟	mk	ib
酩	mk	yk
谬	mq	yp
莫	mo	cd
魔	mo	gg
膜	mo	od
磨	mo	gu
摸	mo	fd
末	mo	an
麽	mo	gm
墨	mo	ht
默	mo	hq
模	mo	md
馍	mo	ud
沫	mo	dm
摹	mo	cu
殁	mo	dy
陌	mo	eb
茉	mo	cm
谟	mo	yd
貘	mo	vd
漠	mo	dd
貊	mo	vb
镆	mo	jd
蘑	mo	cu
蓦	mo	cm
秣	mo	hm
寞	mo	bd
万	mo	ap
瘼	mo	bd
嬷	mo	nm
耱	mo	lu
无	mo	ay
嫫	mo	nd
靺	mo	gm
藦	mo	cu
𬙊	mo	st
某	mz	gm
谋	mz	ym
牟	mz	sn
眸	mz	on
哞	mz	kn
侔	mz	rn
鍪	mz	sj
蛑	mz	in
木	mu	un
目	mu	ka
姆	mu	nm
墓	mu	ct
母	mu	vd
穆	mu	hp
沐	mu	dm
亩	mu	wt
牧	mu	nw
暮	mu	co
慕	mu	cx
幕	mu	cj
钼	mu	jo
募	mu	cl
牡	mu	nt
拇	mu	fm
睦	mu	ot
呒	mu	kw
苜	mu	co
仫	mu	rm
毪	mu	mn
𧿹	mu	zm
𬭁	mu	jm
那	na	ve
拿	na	ru
哪	na	ke
呐	na	kn
娜	na	ne
纳	na	sn
钠	na	jn
捺	na	fx
镎	na	ju
衲	na	pn
乸	na	ym
南	na	ug
肭	na	on
𦰡	na	ce
乃	nd	vp
奶	nd	nn
耐	nd	ec
奈	nd	dx
氖	nd	qn
萘	nd	cx
柰	nd	mx
迺	nd	zx
艿	nd	cn
鼐	nd	nv
佴	nd	re
难	nj	yf
男	nj	tl
楠	nj	mg
喃	nj	kg
腩	nj	og
囡	nj	kn
赧	nj	ty
蝻	nj	ig
婻	nj	ng
萳	nj	cg
囊	nh	ay
馕	nh	uy
曩	nh	oy
攮	nh	fy
齉	nh	zy
囔	nh	ky
脑	nc	ok
闹	nc	mj
挠	nc	fw
恼	nc	xk
瑙	nc	wx
淖	nc	du
孬	nc	bz
铙	nc	jw
垴	nc	tk
呶	nc	ky
猱	nc	qm
臑	nc	oe
蛲	nc	iw
硇	nc	ux
峱	nc	qe
呢	ne	kb
讷	ne	yn
内	nw	ld
馁	nw	un
嫩	nf	nw
恁	nf	rx
能	ng	sb
你	ni	rx
尼	ni	ub
逆	ni	zp
拟	ni	fr
泥	ni	db
匿	ni	kk
腻	ni	or
妮	ni	nb
倪	ni	re
溺	ni	dd
铌	ni	jb
昵	ni	ob
霓	ni	ye
睨	ni	oe
伲	ni	rb
鲵	ni	ae
猊	ni	qe
旎	ni	fb
麑	ni	ge
坭	ni	tb
怩	ni	xb
薿	ni	cr
𨺙	ni	ee
𫐐	ni	ie
𫠜	ni	ve
年	nm	pl
念	nm	rx
黏	nm	hk
碾	nm	un
撵	nm	fi
捻	nm	fx
辇	nm	fi
蔫	nm	ch
鲶	nm	ax
拈	nm	fk
廿	nm	ca
鲇	nm	ak
埝	nm	tx
粘	nm	mk
娘	nl	nl
酿	nl	yl
嬢	nl	ny
鸟	nn	wd
尿	nn	uu
茑	nn	cn
脲	nn	ou
袅	nn	py
捏	np	ft
镍	np	jm
涅	np	dt
孽	np	cz
聂	np	ey
镊	np	jy
颞	np	er
蹑	np	zy
臬	np	zm
啮	np	kk
蘖	np	cm
嗫	np	ky
嵲	np	em
菍	np	cx
糵	np	cm
陧	np	et
𫔶	np	mm
您	nb	rx
拧	nk	fd
宁	nk	bd
凝	nk	dr
甯	nk	by
狞	nk	qd
柠	nk	md
苧	nk	cd
佞	nk	rn
泞	nk	dd
咛	nk	kd
聍	nk	ed
牛	nq	pl
扭	nq	fi
妞	nq	ni
纽	nq	si
钮	nq	ji
狃	nq	qi
忸	nq	xi
浓	ns	dn
农	ns	dn
侬	ns	rn
脓	ns	on
秾	ns	hn
哝	ns	kn
𬪩	ns	yn
耨	nz	lc
怒	nu	nx
努	nu	nl
弩	nu	ng
奴	nu	ny
驽	nu	nm
傉	nu	rc
孥	nu	nz
砮	nu	nu
胬	nu	nr
笯	nu	vy
暖	nr	oy
诺	no	yk
挪	no	fe
糯	no	me
喏	no	kk
傩	no	rf
懦	no	xe
搦	no	fd
锘	no	jk
女	nv	va
钕	nv	jn
衄	nv	xi
恧	nv	ex
虐	nt	ha
疟	nt	ba
噢	oo	kd
喔	oo	kt
欧	ou	kr
藕	ou	cy
偶	ou	ry
呕	ou	kx
鸥	ou	kn
区	ou	kx
沤	ou	dx
殴	ou	ky
耦	ou	ly
讴	ou	yx
瓯	ou	kw
怄	ou	xx
𠙶	ou	lk
𬉼	ou	hx
怕	pa	xb
爬	pa	vb
趴	pa	zb
啪	pa	kb
帕	pa	jb
琶	pa	wb
葩	pa	cb
杷	pa	mb
舥	pa	vb
潖	pa	db
筢	pa	vb
拍	pd	fb
派	pd	dn
牌	pd	pu
排	pd	ff
哌	pd	kn
湃	pd	df
俳	pd	rf
蒎	pd	cn
徘	pd	if
迫	pd	zb
簰	pd	vu
盘	pj	vm
判	pj	bd
潘	pj	dt
畔	pj	tb
攀	pj	mu
盼	pj	od
叛	pj	by
爿	pj	vp
磐	pj	vu
泮	pj	db
槃	pj	vm
袢	pj	pb
蟠	pj	it
襻	pj	pu
胖	pj	ob
磻	pj	ut
蹒	pj	zl
旁	ph	wf
庞	ph	gl
滂	ph	df
彷	ph	if
乓	ph	qd
雱	ph	yf
逄	ph	zl
螃	ph	if
耪	ph	lf
鳑	ph	af
跑	pc	zs
泡	pc	ds
抛	pc	fl
袍	pc	ps
匏	pc	ds
庖	pc	gs
咆	pc	ks
狍	pc	qs
疱	pc	bs
脬	pc	oz
配	pw	yj
赔	pw	kk
陪	pw	ek
佩	pw	rj
呸	pw	kp
胚	pw	op
裴	pw	fy
培	pw	tk
醅	pw	yk
珮	pw	wj
沛	pw	dl
辔	pw	sk
旆	pw	fl
锫	pw	jk
帔	pw	jy
霈	pw	yl
衃	pw	xb
喷	pf	kr
盆	pf	bm
湓	pf	dm
捧	pg	fl
碰	pg	uy
彭	pg	up
砰	pg	up
棚	pg	mo
硼	pg	uo
朋	pg	oo
鹏	pg	on
烹	pg	wh
嘭	pg	kp
蓬	pg	cz
膨	pg	op
篷	pg	vz
澎	pg	dp
芃	pg	cf
蟛	pg	ip
抨	pg	fp
椪	pg	my
怦	pg	xp
弸	pg	go
堋	pg	to
淜	pg	do
皮	pi	vy
批	pi	fb
屁	pi	ub
劈	pi	ud
匹	pi	ke
啤	pi	ku
脾	pi	ou
癖	pi	bu
披	pi	fy
铍	pi	jy
丕	pi	ba
疲	pi	by
毗	pi	tb
痞	pi	bk
坯	pi	tp
嚭	pi	uk
罴	pi	sh
僻	pi	ru
譬	pi	uk
噼	pi	ku
琵	pi	wb
蜱	pi	iu
貔	pi	vb
圮	pi	tj
邳	pi	pe
郫	pi	pe
伾	pi	rp
霹	pi	yu
媲	pi	nb
澼	pi	du
鼙	pi	uu
陴	pi	eu
甓	pi	uw
睥	pi	ou
埤	pi	tu
淠	pi	dl
狉	pi	qp
枇	pi	mb
砒	pi	ub
蚍	pi	ib
纰	pi	sb
仳	pi	rb
鲏	pi	ay
䴙	pi	un
苉	pi	ce
𬳵	pi	mp
篇	pm	vc
偏	pm	rc
片	pm	pv
骗	pm	mc
骈	pm	mk
谝	pm	yc
翩	pm	hx
楩	pm	mg
胼	pm	ok
蹁	pm	zc
犏	pm	nc
㛹	pm	ng
𡎚	pm	tc
票	pn	xx
飘	pn	xx
漂	pn	dx
嫖	pn	nx
瞟	pn	ox
瓢	pn	xg
剽	pn	xd
缥	pn	sx
朴	pn	mb
殍	pn	dz
薸	pn	cx
嘌	pn	kx
蔈	pn	cx
螵	pn	ix
撇	pp	fw
瞥	pp	do
氕	pp	qp
苤	pp	cp
𬭯	pp	jw
拼	pb	fk
品	pb	kk
频	pb	vr
贫	pb	br
聘	pb	ev
嫔	pb	nb
牝	pb	nb
颦	pb	vu
姘	pb	nk
玭	pb	wb
𬞟	pb	cr
平	pk	au
凭	pk	rj
瓶	pk	bw
评	pk	yp
坪	pk	tp
萍	pk	cp
枰	pk	mp
乒	pk	qp
苹	pk	cp
娉	pk	nv
洴	pk	dk
鲆	pk	ap
俜	pk	rv
泙	pk	dp
玶	pk	wp
涄	pk	dv
帡	pk	jk
荓	pk	ck
蚲	pk	ip
破	po	uy
坡	po	ty
颇	po	vr
泼	po	dd
婆	po	dn
珀	po	wb
魄	po	bg
钋	po	jb
钷	po	jk
粕	po	mb
鄱	po	pe
皤	po	bt
叵	po	kk
酦	po	yd
桲	po	mz
笸	po	vk
䥽	po	jd
剖	pz	ld
裒	pz	wy
掊	pz	fk
抔	pz	fb
谱	pu	yo
铺	pu	jf
扑	pu	fb
普	pu	bo
噗	pu	kn
葡	pu	cf
璞	pu	wn
蒲	pu	cf
仆	pu	rb
浦	pu	df
濮	pu	dn
莆	pu	cf
溥	pu	dc
圃	pu	kf
蹼	pu	zn
镤	pu	jn
镨	pu	jo
菩	pu	ck
酺	pu	yf
匍	pu	bf
蒱	pu	cf
潽	pu	do
墣	pu	tn
氆	pu	mo
穙	pu	hn
其	qi	qb
起	qi	tj
七	qi	av
气	qi	pv
器	qi	kk
骑	qi	mk
齐	qi	wl
棋	qi	mb
漆	qi	du
弃	qi	wc
旗	qi	fb
妻	qi	an
绮	qi	sk
欺	qi	qr
岂	qi	ej
砌	qi	ud
琪	qi	wb
启	qi	hk
企	qi	rv
契	qi	fd
淇	qi	db
泣	qi	dl
鳍	qi	ao
琦	qi	wk
栖	qi	mx
乞	qi	pv
祁	qi	pe
戚	qi	wx
祇	qi	pu
麒	qi	gb
炁	qi	ah
汽	qi	dq
柒	qi	dm
脐	qi	ol
沏	qi	dd
祈	qi	pj
祺	qi	pb
讫	qi	yq
蕲	qi	cj
崎	qi	ek
岐	qi	ey
迄	qi	zq
杞	qi	mj
萁	qi	cb
嘁	qi	kx
欹	qi	dr
槭	qi	mx
锜	qi	jk
凄	qi	dn
碛	qi	ur
畦	qi	tt
歧	qi	vy
綦	qi	qx
玘	qi	wj
芪	qi	cu
亓	qi	el
耆	qi	lo
芑	qi	cj
屺	qi	ej
跂	qi	zy
埼	qi	tk
憩	qi	qx
蜞	qi	ib
棨	qi	hm
葺	qi	ce
汔	qi	dq
蹊	qi	zd
颀	qi	jr
骐	qi	mb
圻	qi	tj
磜	qi	ux
萋	qi	cn
蛴	qi	il
愭	qi	xo
桤	qi	mj
俟	qi	ru
郪	qi	ae
婍	qi	nk
洓	qi	dn
鲯	qi	ab
碶	qi	ud
䓫	qi	ck
𨙸	qi	ue
𬨂	qi	iu
掐	qx	fj
恰	qx	xk
髂	qx	gk
洽	qx	dk
袷	qx	pk
拤	qx	fb
葜	qx	cd
前	qm	bd
钱	qm	jj
签	qm	va
千	qm	pu
浅	qm	dj
欠	qm	dr
铅	qm	jk
牵	qm	dn
遣	qm	zk
潜	qm	do
迁	qm	zq
钳	qm	jg
乾	qm	uq
谦	qm	yn
嵌	qm	er
黔	qm	hv
茜	qm	cx
钤	qm	jv
芡	qm	cr
歉	qm	br
虔	qm	hw
芊	qm	cq
倩	qm	ro
骞	qm	bm
仟	qm	rq
堑	qm	it
搴	qm	bu
阡	qm	eq
汧	qm	dk
谴	qm	yz
褰	qm	by
靬	qm	gg
荨	qm	cc
愆	qm	ix
佥	qm	ra
椠	qm	im
扦	qm	fq
缱	qm	sz
慊	qm	xn
悭	qm	xt
钎	qm	jq
杄	qm	mq
鹐	qm	dn
蒨	qm	co
岍	qm	ek
磏	qm	un
纤	qm	sq
掮	qm	fo
墘	qm	tq
肷	qm	or
圲	qm	tq
伣	qm	re
𬘬	qm	so
抢	ql	fv
枪	ql	mv
墙	ql	tk
腔	ql	og
呛	ql	kv
羌	ql	yv
羟	ql	yg
蔷	ql	ck
炝	ql	hv
锵	ql	jc
戗	ql	rg
戕	ql	pg
锖	ql	jo
樯	ql	mk
玱	ql	wv
镪	ql	ji
蜣	ql	iq
嫱	ql	nk
襁	ql	pi
跄	ql	zv
蔃	ql	ci
敲	qn	wy
桥	qn	ml
乔	qn	yl
翘	qn	ax
瞧	qn	oh
巧	qn	gv
撬	qn	fm
鞘	qn	go
樵	qn	mh
俏	qn	ro
跷	qn	zw
窍	qn	bv
谯	qn	yh
锹	qn	jh
侨	qn	rl
悄	qn	xo
荞	qn	cl
诮	qn	yo
橇	qn	mm
劁	qn	rd
峭	qn	eo
缲	qn	sm
硚	qn	ul
鞒	qn	gl
雀	qn	uf
憔	qn	xh
愀	qn	xh
硗	qn	uw
且	qp	la
切	qp	qd
妾	qp	ln
窃	qp	bd
怯	qp	xs
箧	qp	vj
挈	qp	fu
锲	qp	jd
惬	qp	xj
郄	qp	xe
琴	qb	wv
秦	qb	fh
亲	qb	lm
勤	qb	nl
寝	qb	by
擒	qb	fd
钦	qb	jr
沁	qb	dx
侵	qb	ry
禽	qb	rd
衾	qb	ry
噙	qb	kd
芹	qb	cj
溱	qb	dh
骎	qb	my
嗪	qb	kh
芩	qb	cv
覃	qb	xu
揿	qb	fr
慬	qb	xa
嵚	qb	er
螓	qb	ih
锓	qb	jy
檎	qb	md
吣	qb	kx
请	qk	yo
轻	qk	ig
清	qk	do
情	qk	xo
氢	qk	qg
青	qk	fo
晴	qk	oo
卿	qk	pe
倾	qk	rr
庆	qk	gd
氰	qk	qo
黥	qk	hx
顷	qk	br
磬	qk	uu
擎	qk	cu
鲭	qk	ao
箐	qk	vo
罄	qk	uf
蜻	qk	io
綮	qk	hx
檠	qk	cm
圊	qk	ko
勍	qk	wl
碃	qk	uo
庼	qk	gr
苘	qk	ck
穷	qs	bl
琼	qs	wx
邛	qs	ge
蛩	qs	gi
穹	qs	bg
茕	qs	cu
銎	qs	gj
筇	qs	ve
䓖	qs	cl
球	qq	wq
求	qq	ad
秋	qq	hh
邱	qq	qe
丘	qq	pa
裘	qq	qy
糗	qq	mq
楸	qq	mh
囚	qq	kr
逑	qq	zq
虬	qq	iv
璆	qq	wp
酋	qq	by
萩	qq	ch
遒	qq	zy
鳅	qq	ah
泅	qq	dr
俅	qq	rq
鼽	qq	zj
赇	qq	kq
蚯	qq	iq
蝤	qq	iy
鹙	qq	hn
訄	qq	jk
犰	qq	qj
巯	qq	vv
鞧	qq	gy
𨱇	qq	jq
去	qu	ts
取	qu	ey
曲	qu	la
娶	qu	en
屈	qu	ui
趣	qu	ty
蛆	qu	iq
祛	qu	ps
龋	qu	vy
驱	qu	mx
瞿	qu	of
渠	qu	dm
趋	qu	te
躯	qu	ux
鼩	qu	jk
觑	qu	he
诎	qu	yi
麹	qu	fm
衢	qu	ii
朐	qu	ok
蕖	qu	cm
蘧	qu	cz
袪	qu	ps
胠	qu	os
劬	qu	bl
阒	qu	mq
癯	qu	bf
璩	qu	wu
鸲	qu	bn
戌	qu	wa
蠼	qu	iy
氍	qu	om
黢	qu	hw
坥	qu	tq
灈	qu	df
岖	qu	ex
蛐	qu	iq
磲	qu	um
竘	qu	lk
㭕	qu	ms
䓛	qu	ci
𪨰	qu	eq
𫭟	qu	tx
全	qr	rw
权	qr	my
劝	qr	yl
券	qr	jd
拳	qr	ju
犬	qr	dd
泉	qr	bu
醛	qr	yw
蜷	qr	iv
荃	qr	cw
颧	qr	cr
诠	qr	yw
佺	qr	rw
铨	qr	jw
鬈	qr	av
痊	qr	bw
绻	qr	sv
筌	qr	vw
畎	qr	tq
悛	qr	xw
辁	qr	iw
棬	qr	mv
瑔	qr	wu
鳈	qr	au
婘	qr	nv
𨟠	qr	oe
却	qt	te
缺	qt	fg
确	qt	uy
卻	qt	
阙	qt	mr
瘸	qt	br
鹊	qt	cn
榷	qt	mf
炔	qt	hg
阕	qt	mt
悫	qt	ux
碏	qt	uo
埆	qt	ty
𬒈	qt	xu
群	qy	yy
裙	qy	pk
囷	qy	kh
逡	qy	zw
然	rj	ph
燃	rj	hh
染	rj	dm
冉	rj	la
髯	rj	ar
蚺	rj	ir
苒	rj	cr
䎃	rj	rx
让	rh	yu
穰	rh	hy
嚷	rh	ky
瓤	rh	wg
攘	rh	fy
壤	rh	ty
瀼	rh	dy
禳	rh	py
儴	rh	ry
蘘	rh	cy
绕	rc	sw
饶	rc	uw
扰	rc	fy
桡	rc	mw
娆	rc	nw
荛	rc	cw
热	re	fh
惹	re	cx
人	rf	pn
任	rf	rr
认	rf	yr
忍	rf	rx
仁	rf	re
刃	rf	dd
壬	rf	pu
韧	rf	wr
饪	rf	ur
稔	rf	hx
妊	rf	nr
衽	rf	pr
纫	rf	sr
仞	rf	rr
轫	rf	ir
讱	rf	yr
纴	rf	sr
荏	rf	cr
葚	rf	cv
仍	rg	rn
扔	rg	fn
日	ri	ka
驲	ri	mo
融	rs	ai
容	rs	bk
蓉	rs	ck
荣	rs	cm
溶	rs	dk
戎	rs	gu
熔	rs	hk
绒	rs	su
茸	rs	ce
冗	rs	bj
榕	rs	mk
镕	rs	jk
狨	rs	qu
嵘	rs	em
瑢	rs	wk
蝾	rs	im
肉	rz	nr
揉	rz	fm
柔	rz	sm
鞣	rz	gm
糅	rz	mm
蹂	rz	zm
𫐓	rz	im
如	ru	nk
入	ru	pn
乳	ru	pv
汝	ru	dn
儒	ru	re
辱	ru	ic
濡	ru	de
茹	ru	ck
铷	ru	jk
襦	ru	pe
褥	ru	pc
蓐	ru	cc
孺	ru	ze
洳	ru	dk
蠕	ru	ie
溽	ru	dc
缛	ru	sc
嬬	ru	ne
嚅	ru	ke
薷	ru	ce
颥	ru	yr
挼	rx	fn
软	rr	ir
阮	rr	ee
堧	rr	td
瓀	rr	we
媆	rr	nd
瑞	rv	we
睿	rv	lo
锐	rv	je
蕊	rv	cx
芮	rv	cn
汭	rv	dn
蚋	rv	in
蕤	rv	cu
枘	rv	mn
润	ry	dw
闰	ry	mw
若	ro	ck
弱	ro	gd
箬	ro	vk
鄀	ro	ce
偌	ro	rk
爇	ro	ch
蒻	ro	cd
婼	ro	nk
撒	sa	fw
仨	sa	rs
萨	sa	ci
洒	sa	dx
飒	sa	lx
卅	sa	al
靸	sa	gj
潵	sa	dw
挲	sa	du
脎	sa	om
赛	sd	br
塞	sd	bt
鳃	sd	ax
腮	sd	ox
噻	sd	kt
三	sj	ae
散	sj	cw
伞	sj	ru
叁	sj	ss
糁	sj	mp
毵	sj	sm
馓	sj	uw
丧	sh	un
桑	sh	ym
嗓	sh	km
颡	sh	yr
搡	sh	fm
磉	sh	um
扫	sc	fe
骚	sc	mi
嫂	sc	ny
搔	sc	fi
臊	sc	om
埽	sc	tj
缫	sc	sg
瘙	sc	bi
溞	sc	di
色	se	db
瑟	se	wb
涩	se	dv
铯	se	jb
啬	se	uk
穑	se	hk
璱	se	wb
森	sf	mm
僧	sg	ro
啥	ua	kk
杀	ua	xm
傻	ua	rw
沙	ua	du
鲨	ua	da
莎	ua	cu
煞	ua	dh
纱	ua	su
砂	ua	uu
痧	ua	bu
厦	ua	iw
嗄	ua	kw
歃	ua	qr
唼	ua	kn
霎	ua	yn
铩	ua	jm
裟	ua	dy
杉	ua	mp
晒	ud	ox
筛	ud	vj
山	uj	lk
删	uj	cd
闪	uj	mr
善	uj	yk
扇	uj	hx
衫	uj	pp
擅	uj	fa
珊	uj	wc
陕	uj	ej
膳	uj	ok
疝	uj	be
煽	uj	hx
骟	uj	mx
赡	uj	kk
钐	uj	jp
讪	uj	ye
剡	uj	hd
缮	uj	sk
鳝	uj	ak
苫	uj	ck
鄯	uj	ye
芟	uj	cy
嬗	uj	na
埏	uj	tz
汕	uj	de
晱	uj	oh
姗	uj	nc
潸	uj	do
跚	uj	zc
蟮	uj	ik
烻	uj	hz
栅	uj	mc
舢	uj	ve
墡	uj	tk
嶦	uj	ek
𫮃	uj	tl
上	uh	la
商	uh	wk
伤	uh	rl
熵	uh	hk
尚	uh	xk
赏	uh	xr
殇	uh	dp
觞	uh	dp
墒	uh	tk
垧	uh	tk
晌	uh	ok
绱	uh	sk
少	uc	xp
烧	uc	hw
稍	uc	ho
勺	uc	bd
捎	uc	fo
哨	uc	ko
邵	uc	de
绍	uc	sk
梢	uc	mo
苕	uc	ck
韶	uc	lk
蛸	uc	io
劭	uc	dl
潲	uc	do
艄	uc	vo
芍	uc	cu
筲	uc	vo
召	uc	dk
睄	uc	oo
柖	uc	mk
玿	uc	wk
社	ue	pt
蛇	ue	ib
设	ue	yy
射	ue	uc
舌	ue	qk
舍	ue	rk
摄	ue	fy
涉	ue	dp
赦	ue	tw
折	ue	fj
奢	ue	do
赊	ue	kx
佘	ue	rx
慑	ue	xy
麝	ue	gc
歙	ue	rr
畲	ue	rt
滠	ue	dy
厍	ue	ii
拾	ue	fk
猞	ue	qk
𪨶	ue	ei
谁	uw	yf
神	uf	pu
深	uf	dm
身	uf	pp
申	uf	ll
肾	uf	lo
沈	uf	dv
甚	uf	qv
审	uf	bu
伸	uf	ru
什	uf	ru
砷	uf	uu
慎	uf	xb
婶	uf	nu
渗	uf	dp
侁	uf	re
诜	uf	ye
哂	uf	kx
蜃	uf	ii
莘	uf	cu
绅	uf	su
瘆	uf	bp
甡	uf	uu
燊	uf	hm
椹	uf	mv
矧	uf	ul
呻	uf	ku
屾	uf	ee
胂	uf	ou
珅	uf	wu
谂	uf	yx
鲹	uf	ap
娠	uf	nn
瞫	uf	ou
𬬹	uf	ju
𬳽	uf	me
生	ug	pf
声	ug	up
省	ug	uo
升	ug	pc
胜	ug	ou
圣	ug	yt
剩	ug	qd
绳	ug	sd
昇	ug	ou
笙	ug	vu
牲	ug	nu
甥	ug	ul
陞	ug	et
嵊	ug	en
眚	ug	uo
是	ui	or
时	ui	oc
式	ui	yg
使	ui	rl
师	ui	lj
事	ui	al
史	ui	ln
诗	ui	yc
市	ui	wj
屎	ui	um
十	ui	al
视	ui	pe
室	ui	bt
试	ui	yg
实	ui	bd
饰	ui	uj
士	ui	ua
氏	ui	pv
湿	ui	dy
食	ui	rl
势	ui	fl
世	ui	av
尸	ui	vp
失	ui	pf
施	ui	fy
始	ui	nk
识	ui	yb
适	ui	zk
狮	ui	qj
矢	ui	pt
嗜	ui	ko
谥	ui	ym
誓	ui	fk
弑	ui	xg
恃	ui	xc
示	ui	ex
释	ui	pl
仕	ui	ru
侍	ui	rc
逝	ui	zj
蚀	ui	ui
奭	ui	db
豕	ui	an
轼	ui	ig
噬	ui	kr
虱	ui	vi
拭	ui	fg
祏	ui	pu
柿	ui	mj
铈	ui	jj
莳	ui	cc
驶	ui	mu
似	ui	rr
舐	ui	qu
筮	ui	vr
湜	ui	dr
栻	ui	mg
螫	ui	ti
贳	ui	ur
蓍	ui	co
酾	ui	yl
炻	ui	hu
鲥	ui	ac
鼫	ui	ju
媞	ui	nr
埘	ui	tc
鸤	ui	un
嘘	ui	ky
鲺	ui	ai
峙	ui	ec
殖	ui	dq
襫	ui	pb
邿	ui	te
浉	ui	dj
䏡	ui	ox
䴓	ui	an
𫚕	ui	aj
𬤊	ui	yr
受	uz	py
手	uz	pl
收	uz	vw
首	uz	bz
瘦	uz	by
守	uz	bc
兽	uz	bk
寿	uz	fc
售	uz	rk
授	uz	fy
熟	uz	wh
艏	uz	vz
绶	uz	sy
狩	uz	qc
书	uu	vd
数	uu	mw
树	uu	mc
属	uu	uy
输	uu	id
术	uu	md
叔	uu	uy
蜀	uu	si
竖	uu	ll
鼠	uu	jv
舒	uu	rl
疏	uu	vv
梳	uu	mv
赎	uu	kd
束	uu	an
孰	uu	ww
述	uu	zu
黍	uu	hu
署	uu	so
姝	uu	nv
塾	uu	wt
恕	uu	nx
淑	uu	dy
庶	uu	gh
戍	uu	wd
漱	uu	dr
殊	uu	dv
暑	uu	oo
殳	uu	jy
曙	uu	oo
薯	uu	co
抒	uu	fl
枢	uu	mx
蔬	uu	cv
菽	uu	cy
澍	uu	dc
倏	uu	rq
摅	uu	fx
腧	uu	od
墅	uu	lt
纾	uu	sl
隃	uu	ed
秫	uu	hu
沭	uu	du
婌	uu	ny
陎	uu	ev
毹	uu	rm
鄃	uu	re
𬬸	uu	ju
刷	ux	ud
耍	ux	en
唰	ux	kd
帅	uk	lj
甩	uk	kv
摔	uk	fu
衰	uk	wy
蟀	uk	iu
涮	ur	dd
栓	ur	mw
拴	ur	fw
闩	ur	ma
腨	ur	oe
双	ul	yy
爽	ul	dx
霜	ul	yo
孀	ul	no
鹴	ul	yn
骦	ul	mo
礵	ul	uo
水	uv	ln
睡	uv	oi
税	uv	he
帨	uv	je
说	uv	ye
顺	uy	ir
舜	uy	pl
瞬	uy	ol
吮	uy	ke
楯	uy	mo
硕	uo	ur
朔	uo	bo
槊	uo	bm
烁	uo	hl
搠	uo	fo
铄	uo	jl
妁	uo	nu
蒴	uo	co
四	si	ke
死	si	db
斯	si	qj
撕	si	fj
丝	si	va
寺	si	tc
思	si	tx
私	si	hs
司	si	vk
嗣	si	kk
饲	si	uk
巳	si	vv
嘶	si	kj
肆	si	ay
祀	si	ps
姒	si	nr
驷	si	me
锶	si	jx
泗	si	de
厮	si	ij
兕	si	ae
笥	si	vk
汜	si	ds
咝	si	ks
鸶	si	sn
涘	si	du
缌	si	sx
耜	si	lk
澌	si	dj
蛳	si	ij
虒	si	pj
飔	si	jx
凘	si	dj
㟃	si	ek
楒	si	mx
送	ss	zt
宋	ss	bm
松	ss	ms
怂	ss	rx
颂	ss	br
诵	ss	yy
崧	ss	es
耸	ss	re
菘	ss	cs
嵩	ss	ek
竦	ss	lu
淞	ss	ds
讼	ss	ys
娀	ss	nu
凇	ss	ds
悚	ss	xu
𪨊	ss	ur
忪	ss	xs
㧐	ss	fy
搜	sz	fy
艘	sz	vy
嗖	sz	ky
馊	sz	uy
叟	sz	py
廋	sz	gy
薮	sz	cw
溲	sz	dy
瞍	sz	oy
嗽	sz	kr
蒐	sz	cg
飕	sz	jy
嗾	sz	ku
擞	sz	fw
锼	sz	jy
螋	sz	iy
苏	su	cb
酥	su	yh
素	su	fx
速	su	zu
俗	su	rk
诉	su	yi
宿	su	bb
粟	su	xm
溯	su	do
塑	su	bt
肃	su	vd
稣	su	ah
谡	su	yw
愫	su	xx
夙	su	jd
甦	su	gu
涑	su	du
窣	su	bu
骕	su	ms
蔌	su	cr
嗉	su	kx
簌	su	vr
傃	su	rx
鹔	su	sn
蹜	su	zb
缩	su	sb
僳	su	rm
觫	su	du
𫗧	su	uu
算	sr	vc
酸	sr	yw
蒜	sr	cx
狻	sr	qw
岁	sv	ex
随	sv	ez
虽	sv	ki
遂	sv	zu
碎	sv	uu
隋	sv	eo
穗	sv	hx
髓	sv	gz
燧	sv	hz
隧	sv	ez
睢	sv	of
绥	sv	sn
祟	sv	ix
荽	sv	cn
谇	sv	yu
眭	sv	ot
濉	sv	df
邃	sv	zu
旞	sv	fz
穟	sv	hz
璲	sv	wz
襚	sv	pz
𫟦	sv	iz
𬭼	sv	jz
孙	sy	zx
损	sy	fr
隼	sy	ru
榫	sy	mu
笋	sy	vy
飧	sy	xl
荪	sy	cx
狲	sy	qx
所	so	pj
锁	so	jr
索	so	ux
嗦	so	kx
梭	so	mw
娑	so	dn
蓑	so	cy
唆	so	kw
琐	so	wr
羧	so	yw
睃	so	ow
溹	so	dx
唢	so	kr
嗍	so	ko
桫	so	mu
他	ta	ry
她	ta	ny
它	ta	bb
塔	ta	tk
塌	ta	tx
踏	ta	zo
祂	ta	py
挞	ta	fz
拓	ta	fu
铊	ta	jb
榻	ta	mx
牠	ta	ny
趿	ta	zj
獭	ta	qr
闼	ta	mz
蹋	ta	zx
鳎	ta	ax
溻	ta	dx
遢	ta	zx
鞳	ta	gk
阘	ta	mx
褟	ta	px
太	td	dd
台	td	sk
态	td	tx
胎	td	ok
抬	td	fk
泰	td	fu
钛	td	jt
肽	td	ot
苔	td	ck
汰	td	dt
鲐	td	ak
邰	td	se
酞	td	yt
薹	td	ct
跆	td	zk
炱	td	sh
谈	tj	yh
碳	tj	uh
摊	tj	ff
贪	tj	rr
痰	tj	bh
探	tj	fm
谭	tj	yu
叹	tj	ky
滩	tj	df
坛	tj	ts
坦	tj	ta
炭	tj	eh
瘫	tj	bf
潭	tj	du
檀	tj	ma
毯	tj	mh
昙	tj	os
钽	tj	ja
倓	tj	rh
忐	tj	ux
郯	tj	he
坍	tj	td
璮	tj	wa
惔	tj	xh
菼	tj	ch
袒	tj	pa
锬	tj	jh
榃	tj	mt
磹	tj	uu
糖	th	mk
汤	th	dp
唐	th	gk
躺	th	uk
烫	th	dh
堂	th	xt
趟	th	tk
棠	th	xm
淌	th	dk
塘	th	tk
倘	th	rk
膛	th	ot
蹚	th	zt
帑	th	nj
樘	th	mt
镗	th	jt
傥	th	re
溏	th	dk
螳	th	it
镋	th	je
搪	th	fk
羰	th	yh
嘡	th	kt
螗	th	ik
瑭	th	wk
鄌	th	ge
耥	th	lk
埫	th	tk
铴	th	jp
䣘	th	xe
套	tc	ds
淘	tc	df
逃	tc	zd
掏	tc	ff
讨	tc	yc
桃	tc	md
陶	tc	ef
韬	tc	wj
涛	tc	dc
弢	tc	gy
饕	tc	kl
绦	tc	sm
绹	tc	sf
洮	tc	dd
滔	tc	dj
萄	tc	cf
焘	tc	fh
梼	tc	mc
慆	tc	xj
啕	tc	kf
鼗	tc	ey
𫘦	tc	mf
特	te	nc
铽	te	jx
慝	te	kx
忑	te	xx
忒	te	yx
疼	tg	bd
藤	tg	cu
腾	tg	om
滕	tg	ou
熥	tg	hz
誊	tg	jk
縢	tg	ox
螣	tg	oi
䲢	tg	oa
题	ti	or
体	ti	rb
踢	ti	zw
替	ti	fo
剃	ti	bd
缇	ti	sr
梯	ti	mp
锑	ti	jp
蹄	ti	zj
剔	ti	od
啼	ti	kj
悌	ti	xp
涕	ti	dp
薙	ti	cf
惕	ti	xw
醍	ti	yr
屉	ti	uu
鳀	ti	ar
嚏	ti	kr
荑	ti	cy
趯	ti	tf
鹈	ti	bn
擿	ti	fz
绨	ti	sp
倜	ti	rk
裼	ti	pw
逖	ti	zh
瑅	ti	wr
遆	ti	zj
䏲	ti	op
䴘	ti	pn
𫘨	ti	mr
天	tm	ad
甜	tm	qg
填	tm	tb
田	tm	ku
舔	tm	qx
添	tm	dx
忝	tm	tx
湉	tm	dk
殄	tm	dp
恬	tm	xk
腆	tm	ob
阗	tm	mb
掭	tm	fx
觍	tm	le
瑱	tm	wb
沺	tm	dt
畋	tm	tw
淟	tm	db
晪	tm	ob
盷	tm	od
黇	tm	ck
条	tn	wm
跳	tn	zd
挑	tn	fd
祧	tn	pd
蜩	tn	ik
窕	tn	bd
朓	tn	od
鲦	tn	am
粜	tn	im
佻	tn	rd
眺	tn	od
嬥	tn	nf
髫	tn	ak
迢	tn	zk
笤	tn	vk
龆	tn	vk
贴	tp	kk
铁	tp	ju
帖	tp	jk
萜	tp	ck
餮	tp	dl
听	tk	kj
挺	tk	fz
停	tk	rd
厅	tk	id
亭	tk	wd
汀	tk	dd
艇	tk	vz
庭	tk	gz
廷	tk	zr
霆	tk	yz
婷	tk	nd
烃	tk	hg
铤	tk	jz
珽	tk	wz
梃	tk	mz
渟	tk	dd
葶	tk	cd
蜓	tk	iz
莛	tk	cz
圢	tk	td
桯	tk	mw
颋	tk	rr
侹	tk	rz
烶	tk	hz
䗴	tk	iz
𬘩	tk	sz
同	ts	kk
通	ts	zy
痛	ts	by
铜	ts	jk
桶	ts	my
捅	ts	fy
筒	ts	vk
酮	ts	yk
佟	ts	rd
统	ts	se
童	ts	ll
瞳	ts	ol
桐	ts	mk
彤	ts	dp
砼	ts	ug
嗵	ts	kz
僮	ts	rl
恸	ts	xl
仝	ts	rg
穜	ts	hl
潼	ts	dl
烔	ts	hk
橦	ts	ml
茼	ts	ck
曈	ts	ol
哃	ts	kk
鲖	ts	ak
㛚	ts	ny
峂	ts	ed
𦒍	ts	lx
𫍣	ts	yk
头	tz	dd
投	tz	fy
偷	tz	rd
透	tz	zn
骰	tz	gy
图	tu	kd
土	tu	ua
吐	tu	kt
涂	tu	dh
兔	tu	dd
突	tu	bq
屠	tu	uo
徒	tu	ir
凸	tu	la
秃	tu	hj
途	tu	zh
荼	tu	ch
钍	tu	jt
酴	tu	yh
菟	tu	cd
凃	tu	dh
稌	tu	hh
堍	tu	td
腯	tu	oo
梌	tu	mh
葖	tu	cq
㻬	tu	wk
𬳿	tu	mh
团	tr	kc
彖	tr	vu
抟	tr	fv
湍	tr	de
猯	tr	qe
疃	tr	tl
煓	tr	he
推	tv	ff
腿	tv	oz
退	tv	zg
褪	tv	pz
颓	tv	hr
蜕	tv	ie
煺	tv	hz
魋	tv	gf
𬯎	tv	er
臀	ty	uo
吞	ty	tk
屯	ty	av
豚	ty	ou
鲀	ty	at
暾	ty	ow
焞	ty	hz
饨	ty	ut
坉	ty	tt
忳	ty	xt
拖	to	fy
托	to	fq
脱	to	oe
坨	to	tb
陀	to	eb
驼	to	mb
妥	to	pn
佗	to	rb
侂	to	rq
唾	to	ki
橐	to	am
沱	to	db
鼍	to	kd
鸵	to	nb
椭	to	mo
萚	to	cl
砣	to	ub
柁	to	mb
箨	to	vl
柝	to	mi
跎	to	zb
酡	to	yb
圫	to	tq
庹	to	gi
𬶍	to	ab
哇	wa	kt
挖	wa	fv
娃	wa	nt
瓦	wa	ad
蛙	wa	it
袜	wa	pm
洼	wa	dt
娲	wa	nn
佤	wa	rw
窊	wa	bg
坬	wa	tg
腽	wa	om
畖	wa	tg
外	wd	xb
歪	wd	bv
崴	wd	en
玩	wj	we
完	wj	be
晚	wj	ov
碗	wj	uv
弯	wj	wg
丸	wj	pd
湾	wj	dg
挽	wj	fv
纨	wj	sw
绾	wj	sk
烷	wj	he
腕	wj	ov
剜	wj	bd
皖	wj	be
菀	wj	cv
卍	wj	vl
宛	wj	bv
顽	wj	er
豌	wj	av
婉	wj	nv
脘	wj	oe
畹	wj	tv
椀	wj	mv
芄	wj	cw
婠	wj	nk
琬	wj	wv
惋	wj	xv
蜿	wj	iv
塆	wj	tg
𬇕	wj	dw
往	wh	iv
王	wh	at
网	wh	kx
望	wh	ww
忘	wh	wx
汪	wh	dw
亡	wh	wv
旺	wh	ow
妄	wh	wn
枉	wh	mw
罔	wh	kw
辋	wh	iw
惘	wh	xw
尢	wh	uv
魍	wh	gw
尪	wh	yw
为	ww	dd
位	ww	rl
未	ww	an
味	ww	kw
微	ww	iw
喂	ww	kn
伪	ww	rw
胃	ww	to
维	ww	sf
威	ww	xn
魏	ww	hg
唯	ww	kf
尾	ww	um
卫	ww	va
谓	ww	yo
韦	ww	al
围	ww	kw
惟	ww	xf
薇	ww	cw
委	ww	hn
危	ww	dv
煨	ww	hn
畏	ww	tn
伟	ww	rw
隈	ww	en
违	ww	zw
苇	ww	cw
萎	ww	cn
炜	ww	hw
慰	ww	ux
尉	ww	uc
纬	ww	sw
鲔	ww	ao
蔚	ww	cc
圩	ww	ty
洧	ww	do
玮	ww	ww
艉	ww	vm
帷	ww	jf
渭	ww	do
帏	ww	jw
桅	ww	mv
猥	ww	qn
痿	ww	bn
廆	ww	gg
巍	ww	eg
嵬	ww	eg
猬	ww	qo
薳	ww	cz
鳚	ww	ac
潍	ww	df
亹	ww	wq
葳	ww	cn
偎	ww	rn
闱	ww	mw
诿	ww	yn
韪	ww	ow
娓	ww	nm
隗	ww	eg
溦	ww	dw
沩	ww	dw
硙	ww	uj
煟	ww	ho
逶	ww	zn
霨	ww	yc
碨	ww	un
涠	ww	dw
洈	ww	dv
琟	ww	wf
峗	ww	ev
螱	ww	ui
鳂	ww	an
𣲗	ww	dw
𫇭	ww	cw
𬀩	ww	ow
𬱟	ww	dr
𬶏	ww	av
问	wf	mk
文	wf	wx
稳	wf	hx
闻	wf	me
纹	wf	sw
温	wf	dm
吻	wf	kw
蚊	wf	iw
瘟	wf	bm
玟	wf	ww
雯	wf	yw
汶	wf	dw
炆	wf	hw
辒	wf	im
刎	wf	wd
阌	wf	my
紊	wf	wx
蕰	wf	cm
榅	wf	mm
芠	wf	cw
鳁	wf	am
璺	wf	py
𫘜	wf	mw
翁	wg	bx
嗡	wg	kx
瓮	wg	bw
滃	wg	dx
蓊	wg	cx
蕹	wg	cf
鹟	wg	bn
𬭩	wg	jx
我	wo	pd
窝	wo	bn
握	wo	ft
沃	wo	dy
卧	wo	ib
斡	wo	uu
倭	wo	rn
龌	wo	vt
渥	wo	dt
偓	wo	rt
肟	wo	ok
蜗	wo	in
挝	wo	fz
幄	wo	jt
硪	wo	uw
涴	wo	dv
莴	wo	cn
踒	wo	zn
五	wu	aa
物	wu	nw
吾	wu	wk
吴	wu	kt
勿	wu	bp
乌	wu	pa
舞	wu	pl
武	wu	av
屋	wu	ut
误	wu	yt
悟	wu	xk
唔	wu	kk
雾	wu	yl
捂	wu	fk
伍	wu	rw
戊	wu	gp
污	wu	dk
兀	wu	ae
呜	wu	kw
巫	wu	gr
午	wu	pg
务	wu	wl
钨	wu	jw
坞	wu	tw
毋	wu	va
邬	wu	we
诬	wu	yr
寤	wu	bk
庑	wu	gw
侮	wu	rm
芜	wu	cw
焐	wu	hk
旿	wu	ow
忤	wu	xw
鹜	wu	sn
鼯	wu	jk
晤	wu	ok
骛	wu	sm
梧	wu	mk
迕	wu	zw
杌	wu	mw
鹀	wu	gn
圬	wu	tk
妩	wu	nw
怃	wu	xw
芴	wu	cw
洿	wu	dk
浯	wu	dk
珷	wu	wv
婺	wu	sn
鋈	wu	dj
屼	wu	ew
鹉	wu	an
铻	wu	jk
珸	wu	wk
蜈	wu	it
牾	wu	nk
郚	wu	we
仵	wu	rw
痦	wu	bk
靰	wu	gw
峿	wu	ek
𣲘	wu	dw
洗	xi	de
戏	xi	yg
西	xi	aa
细	xi	st
吸	xi	kj
喜	xi	uk
兮	xi	bv
希	xi	xj
席	xi	gj
膝	xi	ou
稀	xi	hj
锡	xi	jw
息	xi	zx
奚	xi	pd
习	xi	vd
硒	xi	ux
昔	xi	co
惜	xi	xo
溪	xi	dd
袭	xi	ly
徙	xi	ir
悉	xi	px
析	xi	mj
曦	xi	od
玺	xi	dy
隙	xi	ex
熄	xi	hx
蜥	xi	ij
夕	xi	pd
汐	xi	dx
熙	xi	kh
嘻	xi	kk
檄	xi	mw
铣	xi	je
羲	xi	yd
晞	xi	oj
烯	xi	hj
豨	xi	uj
晰	xi	oj
犀	xi	un
禧	xi	pk
隰	xi	eh
嬉	xi	nk
釐	xi	wl
郤	xi	be
咥	xi	kt
谿	xi	pk
郗	xi	xe
牺	xi	nx
禊	xi	pd
翕	xi	rx
僖	xi	rk
熹	xi	uh
觋	xi	ge
皙	xi	mb
醯	xi	ym
媳	xi	nx
枲	xi	sm
嶲	xi	ev
饩	xi	uq
傒	xi	rd
憙	xi	ux
唏	xi	kj
舄	xi	jh
浠	xi	dj
舾	xi	vx
淅	xi	dj
螅	xi	ix
肸	xi	ou
屣	xi	ur
觿	xi	dk
酅	xi	ee
穸	xi	bx
屃	xi	ur
蓰	xi	cr
菥	xi	cj
潟	xi	dh
鳛	xi	ab
绤	xi	sk
鼷	xi	jd
阋	xi	me
蟋	xi	ix
葸	xi	cx
樨	xi	mn
爔	xi	hd
巇	xi	eg
睎	xi	oj
熻	xi	hx
粞	xi	mx
窸	xi	bx
俙	xi	rj
恓	xi	xx
嶍	xi	eb
暿	xi	ok
饻	xi	uy
𠅤	xi	wx
𫘬	xi	md
𬭳	xi	jk
𬶮	xi	ak
下	xx	ab
瞎	xx	ok
夏	xx	aw
侠	xx	rj
虾	xx	ix
霞	xx	yy
狭	xx	qj
峡	xx	ej
瑕	xx	wy
匣	xx	kj
辖	xx	ik
呷	xx	kj
叚	xx	vy
暇	xx	oy
狎	xx	qj
遐	xx	zy
硖	xx	uj
罅	xx	fh
柙	xx	mj
黠	xx	hk
翈	xx	jx
先	xm	ne
线	xm	sj
险	xm	ea
弦	xm	gy
现	xm	we
县	xm	qs
嫌	xm	nn
仙	xm	re
咸	xm	xk
显	xm	oy
鲜	xm	ay
限	xm	eg
闲	xm	mm
藓	xm	cy
馅	xm	uj
献	xm	uq
贤	xm	lr
掀	xm	fr
陷	xm	ej
酰	xm	ye
衔	xm	ii
氙	xm	qe
腺	xm	ou
娴	xm	nm
羡	xm	yr
霰	xm	yw
筅	xm	ve
宪	xm	be
籼	xm	me
蚬	xm	ie
舷	xm	vy
涎	xm	dz
冼	xm	de
岘	xm	ee
苋	xm	ce
狝	xm	qx
跣	xm	ze
燹	xm	uh
锨	xm	jr
祆	xm	pt
暹	xm	zf
痫	xm	bm
缐	xm	su
猃	xm	qa
伭	xm	ry
崄	xm	ea
跹	xm	zz
莶	xm	ca
挦	xm	fc
孅	xm	nj
忺	xm	xr
鹇	xm	mn
禒	xm	pu
㬎	xm	oh
𪾢	xm	oe
𫍯	xm	yk
𬀪	xm	oe
𬸣	xm	bn
想	xl	mx
像	xl	rn
向	xl	pk
项	xl	gr
香	xl	ho
相	xl	mo
象	xl	dn
箱	xl	vo
乡	xl	vp
响	xl	kk
翔	xl	yx
橡	xl	mn
享	xl	wz
湘	xl	do
祥	xl	py
镶	xl	jy
厢	xl	io
饷	xl	uk
详	xl	yy
飨	xl	xl
襄	xl	wy
芗	xl	cx
庠	xl	gy
骧	xl	my
缃	xl	so
鲞	xl	ja
瓖	xl	wy
珦	xl	wk
葙	xl	co
𬙋	xl	sy
小	xn	ld
笑	xn	vy
肖	xn	xo
箫	xn	vs
孝	xn	lz
逍	xn	zo
萧	xn	cs
消	xn	do
削	xn	xd
晓	xn	ow
枭	xn	pm
效	xn	ww
销	xn	jo
鸮	xn	kn
宵	xn	bo
骁	xn	mw
魈	xn	go
硝	xn	uo
咲	xn	kt
崤	xn	eo
啸	xn	ks
枵	xn	mv
筱	xn	vw
绡	xn	so
霄	xn	yo
潇	xn	ds
嚣	xn	kk
虓	xn	jj
翛	xn	rx
猇	xn	qj
淆	xn	do
皛	xn	bb
哓	xn	kw
哮	xn	kz
洨	xn	dx
涍	xn	dz
滧	xn	dw
蟏	xn	is
敩	xn	xw
𫍲	xn	yy
写	xp	by
些	xp	ve
鞋	xp	gt
血	xp	pm
谢	xp	yc
斜	xp	ru
蟹	xp	di
邪	xp	ye
携	xp	fn
卸	xp	we
歇	xp	or
屑	xp	uo
挟	xp	fj
协	xp	ub
泻	xp	dy
泄	xp	du
蝎	xp	iv
偕	xp	rb
械	xp	mc
燮	xp	hy
谐	xp	yb
胁	xp	ob
榭	xp	mc
楔	xp	md
懈	xp	xn
薤	xp	cj
澥	xp	dn
亵	xp	wy
缬	xp	sr
绁	xp	su
撷	xp	fr
獬	xp	qn
廨	xp	gn
渫	xp	dm
薢	xp	cn
勰	xp	lx
偰	xp	rd
瀣	xp	dj
邂	xp	zn
揳	xp	fd
叶	xp	ku
躞	xp	zy
榍	xp	mo
㙦	xp	rt
𤫉	xp	wy
𬹼	xp	vl
新	xb	lj
心	xb	dd
信	xb	rk
芯	xb	cx
辛	xb	lu
锌	xb	ju
薪	xb	cj
欣	xb	jr
鑫	xb	jj
昕	xb	oj
馨	xb	uo
忻	xb	xj
歆	xb	lr
衅	xb	xb
炘	xb	hj
囟	xb	px
伈	xb	rx
䜣	xb	yj
𫷷	xb	gr
型	xk	kt
性	xk	xu
星	xk	ou
形	xk	kp
姓	xk	nu
醒	xk	yu
兴	xk	xb
邢	xk	ke
刑	xk	kd
幸	xk	tg
杏	xk	mk
腥	xk	ou
陉	xk	eg
擤	xk	fl
荇	xk	ci
饧	xk	up
猩	xk	qu
骍	xk	mu
煋	xk	hu
铏	xk	jd
婞	xk	ng
惺	xk	xu
荥	xk	cu
悻	xk	xg
钘	xk	jk
瑆	xk	wu
硎	xk	ud
𫰛	xk	ng
胸	xs	ok
熊	xs	sh
凶	xs	xk
兄	xs	ke
雄	xs	uf
匈	xs	bk
芎	xs	cg
夐	xs	dw
讻	xs	yk
汹	xs	dk
诇	xs	yk
修	xq	rp
秀	xq	hn
休	xq	rm
绣	xq	sn
嗅	xq	kq
溴	xq	dq
袖	xq	py
锈	xq	jn
羞	xq	yi
咻	xq	km
岫	xq	ey
脩	xq	ro
朽	xq	mv
髹	xq	am
琇	xq	wn
貅	xq	vm
庥	xq	gm
滫	xq	do
鸺	xq	rn
珛	xq	wo
馐	xq	ui
䗛	xq	io
需	xu	ye
虚	xu	hy
须	xu	pr
徐	xu	ih
许	xu	yw
续	xu	sd
序	xu	gl
叙	xu	ry
恤	xu	xx
蓄	xu	ct
旭	xu	jo
绪	xu	so
絮	xu	nx
墟	xu	ty
胥	xu	vo
栩	xu	mx
诩	xu	yx
吁	xu	ky
婿	xu	no
昫	xu	ok
煦	xu	oh
媭	xu	pn
勖	xu	kl
蓿	xu	cb
盱	xu	oy
酗	xu	yk
顼	xu	wr
糈	xu	mo
溆	xu	dy
洫	xu	dx
湑	xu	do
醑	xu	yo
旴	xu	oy
垿	xu	tl
魆	xu	gv
谞	xu	yo
珝	xu	wx
㳚	xu	du
冔	xu	ky
𦈡	xu	se
𬣙	xu	yy
选	xr	ze
悬	xr	qx
癣	xr	by
炫	xr	hy
玄	xr	wy
宣	xr	ba
轩	xr	ig
旋	xr	fr
泫	xr	dy
萱	xr	ca
璇	xr	wr
渲	xr	da
喧	xr	ka
玹	xr	wy
烜	xr	ha
铉	xr	jy
瑄	xr	wa
漩	xr	dr
暄	xr	oa
谖	xr	yy
绚	xr	so
楦	xr	ma
衒	xr	ii
煊	xr	ha
眩	xr	oy
咺	xr	ka
儇	xr	ry
禤	xr	px
晅	xr	oa
翾	xr	sx
碹	xr	ua
昡	xr	oy
琄	xr	wo
痃	xr	by
暶	xr	or
愃	xr	xa
𫍽	xr	yy
𫓶	xr	jo
𫠊	xr	my
学	xt	xz
雪	xt	ye
薛	xt	cu
靴	xt	gb
穴	xt	bb
谑	xt	ya
噱	xt	ku
鳕	xt	ae
踅	xt	fr
茓	xt	cb
峃	xt	xe
薰	xy	ch
寻	xy	ec
熏	xy	ph
训	xy	yi
逊	xy	zx
巡	xy	zv
埙	xy	tr
勋	xy	kl
巽	xy	sb
讯	xy	yu
荀	xy	co
循	xy	io
旬	xy	bo
殉	xy	do
洵	xy	do
询	xy	yo
迅	xy	zu
徇	xy	io
驯	xy	mi
蕈	xy	cu
浔	xy	dc
鲟	xy	ac
恂	xy	xo
醺	xy	yh
栒	xy	mo
曛	xy	oh
獯	xy	qh
汛	xy	du
珣	xy	wo
噀	xy	kb
峋	xy	eo
𫄸	xy	sh
𬊈	xy	hc
𬍤	xy	wc
𬘓	xy	si
𬩽	xy	ee
呀	ya	ky
牙	ya	ap
压	ya	id
鸭	ya	jn
亚	ya	ay
雅	ya	yf
押	ya	fj
丫	ya	bl
芽	ya	cy
娅	ya	ny
崖	ya	et
哑	ya	ky
鸦	ya	yn
氩	ya	qy
涯	ya	dt
伢	ya	ry
衙	ya	ii
蚜	ya	iy
垭	ya	ty
猰	ya	qd
玡	ya	wy
琊	ya	we
砑	ya	uy
桠	ya	my
迓	ya	zy
讶	ya	yy
揠	ya	fn
睚	ya	ot
岈	ya	ey
堐	ya	tt
盐	yj	tm
眼	yj	og
演	yj	db
烟	yj	hd
言	yj	wk
沿	yj	dk
研	yj	uk
焉	yj	vh
严	yj	yp
颜	yj	ir
燕	yj	nh
宴	yj	bn
炎	yj	hh
岩	yj	eu
验	yj	ma
咽	yj	kd
延	yj	zv
彦	yj	ip
阎	yj	mj
掩	yj	fd
厌	yj	iq
艳	yj	fb
闫	yj	ms
焰	yj	hj
晏	yj	on
淹	yj	dd
俨	yj	ry
妍	yj	nk
雁	yj	if
鄢	yj	ve
魇	yj	ig
嫣	yj	nh
阏	yj	md
檐	yj	mk
偃	yj	rn
焱	yj	hh
衍	yj	ii
阉	yj	md
砚	yj	ue
甗	yj	hw
兖	yj	we
谳	yj	yq
筵	yj	vz
罨	yj	sd
赝	yj	ir
弇	yj	rc
湮	yj	dt
酽	yj	yy
琰	yj	wh
奄	yj	dd
堰	yj	tn
餍	yj	il
郾	yj	ke
滟	yj	db
沇	yj	de
芫	yj	ce
谚	yj	yp
黡	yj	ih
嬿	yj	nh
唁	yj	kk
胭	yj	od
蜒	yj	iz
渰	yj	dc
墕	yj	th
棪	yj	mh
戭	yj	bg
掞	yj	fh
蝘	yj	in
鼹	yj	jn
崦	yj	ed
厣	yj	ij
殷	yj	py
恹	yj	xq
漹	yj	dh
虤	yj	hj
扊	yj	hh
䶮	yj	lt
觃	yj	kz
𪩘	yj	eq
𫄧	yj	sz
𬙂	yj	sb
𬸘	yj	kn
杨	yh	mp
养	yh	yl
羊	yh	bl
样	yh	my
氧	yh	qy
阳	yh	eo
痒	yh	by
洋	yh	dy
扬	yh	fp
央	yh	lg
仰	yh	re
鞅	yh	gy
漾	yh	dy
旸	yh	op
羕	yh	yy
秧	yh	hy
佯	yh	ry
烊	yh	hy
殃	yh	dy
飏	yh	jp
炀	yh	hp
钖	yh	jp
疡	yh	bp
玚	yh	wp
鸯	yh	yn
恙	yh	yx
垟	yh	ty
蛘	yh	iy
泱	yh	dy
怏	yh	xy
徉	yh	iy
咉	yh	ky
要	yc	xn
药	yc	cu
腰	yc	on
妖	yc	ny
咬	yc	kx
邀	yc	zw
摇	yc	ff
尧	yc	aw
姚	yc	nd
舀	yc	pj
幺	yc	vs
约	yc	su
曜	yc	of
谣	yc	yf
瑶	yc	wf
遥	yc	zf
窑	yc	bf
爻	yc	xx
垚	yc	tt
夭	yc	pd
耀	yc	xf
吆	yc	ky
杳	yc	mo
窈	yc	bl
峣	yc	ew
肴	yc	xo
徭	yc	if
钥	yc	jo
鳐	yc	af
窅	yc	bo
鹞	yc	pn
珧	yc	wd
轺	yc	ik
靿	yc	gl
崾	yc	en
猺	yc	qf
媱	yc	nf
㙘	yc	tn
也	ye	vv
页	ye	ar
野	ye	ll
液	ye	dn
夜	ye	wn
耶	ye	ee
业	ye	la
爷	ye	be
噎	ye	ka
邺	ye	ye
谒	ye	yv
掖	ye	fn
椰	ye	me
曳	ye	lp
冶	ye	dk
腋	ye	on
晔	ye	ou
烨	ye	hu
铘	ye	je
靥	ye	im
倻	ye	re
馌	ye	um
揶	ye	fe
以	yi	vr
一	yi	aa
亿	yi	rv
已	yi	vv
亦	yi	wd
易	yi	ow
矣	yi	su
乙	yi	vv
译	yi	yl
伊	yi	ry
意	yi	lx
仪	yi	ry
依	yi	ry
咦	yi	ky
椅	yi	mk
衣	yi	wy
医	yi	ku
翼	yi	xb
义	yi	dx
异	yi	sc
宜	yi	bq
裔	yi	wk
邑	yi	kb
壹	yi	ua
益	yi	bm
移	yi	hx
奕	yi	wd
夷	yi	an
逸	yi	zd
役	yi	iy
艺	yi	cv
疑	yi	br
忆	yi	xv
倚	yi	rk
姨	yi	ny
遗	yi	zr
议	yi	yy
噫	yi	kx
蚁	yi	iy
抑	yi	fe
胰	yi	oy
怡	yi	xk
乂	yi	pn
驿	yi	ml
溢	yi	dm
铱	yi	jy
翊	yi	lx
疫	yi	by
埸	yi	tw
刈	yi	xd
颐	yi	kr
懿	yi	ux
钇	yi	jv
诣	yi	yo
贻	yi	kk
毅	yi	ly
彝	yi	vc
猗	yi	qk
翳	yi	kx
揖	yi	fe
弋	yi	ad
轶	yi	iu
祎	yi	pw
羿	yi	xc
镒	yi	jm
佚	yi	ru
燚	yi	hh
谊	yi	yq
弈	yi	wc
诒	yi	yk
咿	yi	ky
扆	yi	hy
沂	yi	dj
镱	yi	jx
佾	yi	ro
浥	yi	db
臆	yi	ox
瘗	yi	bt
殪	yi	da
缢	yi	sm
苡	yi	cr
峄	yi	el
圯	yi	ts
绎	yi	sl
熠	yi	hb
迤	yi	zy
劓	yi	zd
翌	yi	xl
挹	yi	fb
漪	yi	dk
饴	yi	uk
嶷	yi	er
肄	yi	by
匜	yi	ky
屹	yi	eq
裛	yi	wy
潩	yi	db
舣	yi	vy
薏	yi	cx
怿	yi	xl
踦	yi	zk
螠	yi	im
簃	yi	vx
黟	yi	hx
旖	yi	fk
洢	yi	dy
繄	yi	kx
佁	yi	rk
悒	yi	xb
嫕	yi	nx
鹢	yi	bn
勚	yi	ul
呓	yi	kv
眙	yi	ok
蜴	yi	iw
癔	yi	bx
酏	yi	yy
鹝	yi	an
廙	yi	gb
枍	yi	mv
痍	yi	by
杙	yi	my
宧	yi	bl
椸	yi	my
扅	yi	hx
㑊	yi	rd
𫄷	yi	sx
𫖮	yi	er
𬟁	yi	cn
𬬩	yi	jy
𬺈	yi	vk
因	yb	kd
音	yb	lo
银	yb	jg
印	yb	pe
引	yb	gl
饮	yb	ur
阴	yb	eo
隐	yb	ex
瘾	yb	bx
胤	yb	pv
吟	yb	kv
尹	yb	vp
寅	yb	bb
荫	yb	co
淫	yb	dr
龈	yb	vg
铟	yb	jd
茵	yb	cd
蚓	yb	il
洇	yb	dd
鄞	yb	ne
愔	yb	xo
堙	yb	tt
骃	yb	md
喑	yb	ko
垠	yb	tg
窨	yb	bo
氤	yb	qd
禋	yb	pt
嚚	yb	kk
霪	yb	yr
姻	yb	nd
訚	yb	mk
龂	yb	vj
崟	yb	ej
茚	yb	ce
慭	yb	lx
夤	yb	xb
溵	yb	dy
狺	yb	qk
蟫	yb	iu
吲	yb	kl
硍	yb	ug
珢	yb	wg
歅	yb	xr
䲟	yb	ae
𬘡	yb	sd
𬤇	yb	yt
𬮱	yb	mt
应	yk	ga
硬	yk	ug
赢	yk	wf
英	yk	cy
营	yk	ck
樱	yk	mn
影	yk	op
嘤	yk	kn
鹰	yk	gn
迎	yk	ze
盈	yk	nm
嬴	yk	wf
郢	yk	ke
瑛	yk	wy
蝇	yk	id
莺	yk	cn
颖	yk	br
映	yk	oy
萤	yk	ci
婴	yk	kn
瀛	yk	df
颍	yk	br
莹	yk	cy
媵	yk	on
鹦	yk	kn
膺	yk	go
缨	yk	sn
瘿	yk	bn
楹	yk	mm
荧	yk	ch
萦	yk	cx
罂	yk	kf
撄	yk	fn
锳	yk	jy
滢	yk	dy
溁	yk	dm
潆	yk	dx
蓥	yk	cj
璎	yk	wn
茔	yk	ct
媖	yk	ny
䓨	yk	cf
哟	yo	ku
唷	yo	ko
育	yo	wo
用	ys	kl
勇	ys	sl
永	ys	dn
咏	ys	ky
拥	ys	fy
庸	ys	gl
雍	ys	wf
蛹	ys	iy
颙	ys	yr
俑	ys	ry
佣	ys	ry
慵	ys	xl
泳	ys	dy
痈	ys	by
踊	ys	zy
壅	ys	wt
鄘	ys	ge
甬	ys	sy
镛	ys	jl
鳙	ys	al
饔	ys	wl
邕	ys	vb
澭	ys	df
臃	ys	of
墉	ys	tl
喁	ys	ky
恿	ys	sx
埇	ys	ty
栐	ys	my
㶲	ys	hy
鲬	ys	ay
有	yz	uo
又	yz	vn
由	yz	la
油	yz	dy
右	yz	uk
游	yz	dz
呦	yz	kl
优	yz	ry
友	yz	uy
尤	yz	yd
铀	yz	jy
鼬	yz	jy
祐	yz	pk
犹	yz	qy
佑	yz	rk
忧	yz	xy
幽	yz	ey
釉	yz	py
幼	yz	yl
邮	yz	ye
疣	yz	by
酉	yz	xa
悠	yz	rx
诱	yz	yn
柚	yz	my
宥	yz	bo
攸	yz	rw
鱿	yz	ay
繇	yz	px
囿	yz	ko
卣	yz	la
侑	yz	ro
铕	yz	jo
牖	yz	pf
猷	yz	bq
蚴	yz	il
莠	yz	cn
麀	yz	gb
羑	yz	yj
鲉	yz	ay
莜	yz	cw
黝	yz	hl
莸	yz	cy
耰	yz	lw
槱	yz	mh
浟	yz	dw
蝣	yz	iz
蚰	yz	iy
𬨎	yz	iy
与	yu	aa
于	yu	al
鱼	yu	da
宇	yu	by
於	yu	fd
欲	yu	br
语	yu	yk
雨	yu	ad
余	yu	rh
预	yu	sr
御	yu	ie
玉	yu	wd
域	yu	ta
羽	yu	xx
瑜	yu	wd
遇	yu	zy
禹	yu	pd
逾	yu	zd
愈	yu	rx
俞	yu	rd
予	yu	sl
虞	yu	ht
渔	yu	da
渝	yu	dd
愚	yu	yx
豫	yu	sn
驭	yu	my
裕	yu	pk
喻	yu	kd
隅	yu	ey
郁	yu	ue
瘀	yu	bd
狱	yu	qq
浴	yu	dk
舆	yu	pb
彧	yu	ad
娱	yu	nt
鹬	yu	sn
峪	yu	ek
芋	yu	cy
淤	yu	dd
誉	yu	xk
昱	yu	ol
欤	yu	yr
谕	yu	yd
寓	yu	by
榆	yu	md
鬻	yu	gl
毓	yu	pv
煜	yu	hl
愉	yu	xd
阈	yu	ma
圉	yu	kg
盂	yu	ym
聿	yu	vl
瑀	yu	wy
鄅	yu	ye
迂	yu	zy
庾	yu	gy
屿	yu	ey
禺	yu	ld
竽	yu	vy
遹	yu	zk
淯	yu	do
妤	yu	nl
窳	yu	bg
纡	yu	sy
钰	yu	jy
妪	yu	nx
鹆	yu	bn
俣	yu	rt
雩	yu	yk
棫	yu	ma
燠	yu	hd
腴	yu	oy
舁	yu	jc
玙	yu	wy
谀	yu	yy
矞	yu	sk
敔	yu	ww
饫	yu	uy
畬	yu	rt
熨	yu	uh
潏	yu	dk
堉	yu	to
嵛	yu	ed
蜮	yu	ia
圄	yu	kk
艅	yu	vh
揄	yu	fd
萸	yu	cy
邘	yu	ye
臾	yu	pn
褕	yu	pd
燏	yu	hk
窬	yu	bd
髃	yu	gy
瘐	yu	by
龉	yu	vk
嵎	yu	ey
觎	yu	re
狳	yu	qh
滪	yu	dr
伛	yu	rx
蝓	yu	id
蓣	yu	cr
悆	yu	rx
㺄	yu	qd
元	yr	ee
原	yr	ix
远	yr	ze
源	yr	dx
圆	yr	kr
愿	yr	ix
院	yr	ee
员	yr	kr
园	yr	ke
袁	yr	ty
缘	yr	su
猿	yr	qy
怨	yr	xx
冤	yr	bd
苑	yr	cv
渊	yr	dl
垣	yr	ta
爰	yr	py
援	yr	fy
鸢	yr	yn
掾	yr	fu
鼋	yr	ed
螈	yr	ix
沅	yr	de
妧	yr	ne
媛	yr	ny
塬	yr	tx
瑗	yr	wy
鸳	yr	xn
嫄	yr	nx
辕	yr	iy
垸	yr	te
橼	yr	mu
蜎	yr	io
眢	yr	xo
湲	yr	dy
箢	yr	vv
羱	yr	yx
𫘪	yr	mx
月	yt	ka
越	yt	tv
曰	yt	ka
粤	yt	pv
岳	yt	qe
悦	yt	xe
阅	yt	me
钺	yt	jv
跃	yt	zy
玥	yt	wo
樾	yt	mv
刖	yt	od
籥	yt	vc
龠	yt	rc
瀹	yt	dc
爚	yt	hc
彟	yt	ey
𫐄	yt	iw
𬸚	yt	qn
云	yy	es
运	yy	zs
晕	yy	oi
韵	yy	ld
孕	yy	nz
匀	yy	bd
允	yy	se
芸	yy	cs
陨	yy	er
愠	yy	xm
蕴	yy	cm
殒	yy	dr
昀	yy	od
妘	yy	ns
赟	yy	wr
狁	yy	qe
韫	yy	wm
恽	yy	xi
氲	yy	qm
缊	yy	sm
酝	yy	ys
郓	yy	be
耘	yy	ls
郧	yy	ke
筼	yy	vr
煴	yy	hm
沄	yy	ds
纭	yy	ss
鋆	yy	tj
涢	yy	dr
馧	yy	hm
𫖳	yy	yr
咋	za	kv
砸	za	uj
杂	za	jm
咂	za	kj
匝	za	kj
扎	za	fv
拶	za	fx
臜	za	or
在	zd	ut
再	zd	ar
载	zd	ui
哉	zd	uk
宰	zd	bu
崽	zd	ex
仔	zd	rz
栽	zd	um
灾	zd	bh
甾	zd	vt
赞	zj	nr
咱	zj	kz
暂	zj	io
簪	zj	vo
錾	zj	ij
瓒	zj	wr
昝	zj	wo
酂	zj	ne
趱	zj	tr
糌	zj	mo
寁	zj	br
脏	zh	ot
葬	zh	cc
臧	zh	wi
牂	zh	py
赃	zh	kt
奘	zh	pd
驵	zh	mq
早	zc	ou
造	zc	zk
遭	zc	zo
灶	zc	ht
糟	zc	mo
枣	zc	ad
凿	zc	yk
澡	zc	dm
皂	zc	bq
燥	zc	hm
藻	zc	cm
躁	zc	zm
噪	zc	km
蚤	zc	ii
慥	zc	xz
璪	zc	wm
簉	zc	vz
唣	zc	kq
𥖨	zc	um
则	ze	kd
啧	ze	kr
泽	ze	dl
择	ze	fl
责	ze	fr
仄	ze	ir
帻	ze	jr
昃	ze	or
笮	ze	vv
迮	ze	zv
箦	ze	vr
赜	ze	kr
舴	ze	vv
贼	zw	ku
鲗	zw	ad
怎	zf	vx
谮	zf	yo
增	zg	to
赠	zg	ko
缯	zg	so
甑	zg	bw
憎	zg	xo
鄫	zg	be
罾	zg	so
矰	zg	uo
锃	zg	jw
综	zg	sx
䎖	zg	bx
炸	va	hv
渣	va	da
榨	va	mv
乍	va	pa
札	va	mv
闸	va	mj
诈	va	yv
眨	va	of
吒	va	kq
咤	va	kq
铡	va	jd
揸	va	fa
鲊	va	av
砟	va	uv
楂	va	ma
劄	va	vd
哳	va	kj
霅	va	yk
拃	va	fv
溠	va	dg
奓	va	dx
蚱	va	iv
挓	va	fq
柞	va	mv
痄	va	bv
䃎	va	ux
鲝	va	ya
齇	va	zq
债	vd	rr
窄	vd	bv
宅	vd	bq
摘	vd	fk
寨	vd	bm
斋	vd	we
瘵	vd	bx
豸	vd	pp
站	vj	lk
占	vj	lk
战	vj	lg
斩	vj	ij
沾	vj	dk
展	vj	un
詹	vj	dk
蘸	vj	ch
栈	vj	mj
盏	vj	jm
毡	vj	mk
瞻	vj	ok
旃	vj	fd
绽	vj	sr
湛	vj	dv
辗	vj	in
鳣	vj	aa
鹯	vj	wn
飐	vj	jk
崭	vj	ej
栴	vj	md
谵	vj	yk
偡	vj	rv
搌	vj	fn
𫗴	vj	ua
张	vh	gi
章	vh	lu
涨	vh	di
帐	vh	ji
账	vh	ki
仗	vh	rv
掌	vh	xu
杖	vh	mv
胀	vh	oi
丈	vh	an
彰	vh	lp
障	vh	eu
蟑	vh	iu
璋	vh	wu
鄣	vh	le
瘴	vh	bu
樟	vh	mu
漳	vh	du
獐	vh	qu
嶂	vh	eu
幛	vh	ju
仉	vh	rj
嫜	vh	nu
暲	vh	ou
找	vc	fg
招	vc	fk
照	vc	oh
赵	vc	tx
兆	vc	ed
罩	vc	su
诏	vc	yk
昭	vc	ok
着	vc	yo
棹	vc	mu
肇	vc	hy
沼	vc	dk
钊	vc	jd
曌	vc	og
爪	vc	pn
旐	vc	fd
笊	vc	vv
啁	vc	kk
𬬿	vc	jk
𬶐	vc	av
这	ve	zw
者	ve	lo
浙	ve	dj
遮	ve	zh
哲	ve	fk
辄	ve	iv
锗	ve	jo
褶	ve	pb
蛰	ve	fi
辙	ve	iw
啫	ve	ko
柘	ve	mu
谪	ve	yk
蜇	ve	fi
喆	ve	uk
赭	ve	to
磔	ve	um
蔗	ve	ch
晢	ve	fo
詟	ve	lk
鹧	ve	gn
䗪	ve	gi
真	vf	ub
朕	vf	ot
镇	vf	jb
帧	vf	jr
针	vf	ju
阵	vf	ei
枕	vf	mv
震	vf	yn
臻	vf	ah
珍	vf	wp
甄	vf	xw
贞	vf	lr
振	vf	fn
箴	vf	vk
缜	vf	sb
诊	vf	yp
斟	vf	qu
侦	vf	rr
鸩	vf	dn
祯	vf	pr
砧	vf	uk
赈	vf	kn
榛	vf	mh
轸	vf	ip
疹	vf	bp
桢	vf	mr
胗	vf	op
圳	vf	ti
畛	vf	tp
稹	vf	hb
禛	vf	pb
鬒	vf	ab
瑧	vf	wh
葴	vf	ck
揕	vf	fv
蓁	vf	ch
袗	vf	pp
浈	vf	dr
昣	vf	op
纼	vf	sl
正	vg	av
证	vg	yv
挣	vg	fl
蒸	vg	ch
整	vg	uv
症	vg	bv
争	vg	dl
郑	vg	be
征	vg	iv
政	vg	vw
睁	vg	ol
筝	vg	vl
怔	vg	xv
烝	vg	lh
钲	vg	jv
铮	vg	jl
狰	vg	ql
拯	vg	fa
峥	vg	el
诤	vg	yl
只	vi	kb
之	vi	dn
至	vi	at
值	vi	rq
指	vi	fo
纸	vi	su
制	vi	pd
治	vi	dk
直	vi	uq
知	vi	uk
支	vi	uy
致	vi	aw
质	vi	pr
志	vi	ux
汁	vi	du
置	vi	sq
智	vi	uo
止	vi	la
酯	vi	yo
职	vi	eb
执	vi	fw
掷	vi	fe
枝	vi	my
痣	vi	bx
脂	vi	oo
趾	vi	zv
彘	vi	vb
织	vi	sb
吱	vi	ky
芝	vi	cv
跖	vi	zu
炙	vi	ph
滞	vi	dj
植	vi	mq
秩	vi	hu
旨	vi	bo
侄	vi	rt
栀	vi	mv
徵	vi	iw
祗	vi	pd
陟	vi	ep
芷	vi	cv
窒	vi	bt
肢	vi	oy
址	vi	tv
雉	vi	uf
痔	vi	bc
祉	vi	pv
沚	vi	dv
枳	vi	mb
禔	vi	pr
栉	vi	me
卮	vi	pv
稚	vi	hf
挚	vi	fu
郅	vi	ae
轵	vi	ib
畤	vi	tc
絷	vi	fx
帙	vi	ju
摭	vi	fh
蛭	vi	it
鸷	vi	fn
铚	vi	jt
骘	vi	em
埴	vi	tq
蜘	vi	ik
踬	vi	zr
帜	vi	jb
扺	vi	fu
贽	vi	fr
锧	vi	jr
踯	vi	ze
咫	vi	ib
觯	vi	dl
桎	vi	mt
滍	vi	di
泜	vi	dd
黹	vi	yd
轾	vi	it
跱	vi	zc
忮	vi	xy
稙	vi	hq
疐	vi	ur
胝	vi	od
晊	vi	ot
庤	vi	gc
梽	vi	mx
榰	vi	mo
𦭜	vi	cb
𬃊	vi	mr
中	vs	ll
众	vs	rr
钟	vs	jv
终	vs	sd
冢	vs	bn
忠	vs	vx
肿	vs	ov
仲	vs	rv
盅	vs	vm
锺	vs	jv
柊	vs	md
踵	vs	zv
衷	vs	wy
螽	vs	wi
舯	vs	vv
茽	vs	cv
周	vz	kk
轴	vz	iy
州	vz	dl
粥	vz	gg
咒	vz	kj
肘	vz	oc
洲	vz	dv
舟	vz	pd
皱	vz	dy
昼	vz	ia
纣	vz	sc
胄	vz	yo
骤	vz	mn
宙	vz	by
籀	vz	vt
酎	vz	yc
诌	vz	ye
绉	vz	se
帚	vz	ej
辀	vz	iv
鸼	vz	vn
赒	vz	kk
碡	vz	um
婤	vz	nk
妯	vz	ny
荮	vz	cc
㑇	vz	re
㤘	vz	xe
主	vu	dw
住	vu	rv
注	vu	dv
猪	vu	qo
煮	vu	lh
祝	vu	pe
著	vu	co
朱	vu	pw
柱	vu	mv
渚	vu	do
诸	vu	yo
助	vu	ql
驻	vu	mv
竹	vu	pl
诛	vu	yv
珠	vu	wv
株	vu	mv
铸	vu	jc
逐	vu	zu
筑	vu	vf
蛛	vu	iv
箸	vu	vo
邾	vu	ve
铢	vu	jv
烛	vu	hi
蛀	vu	iv
贮	vu	ka
嘱	vu	ky
拄	vu	fv
茱	vu	cv
炷	vu	hv
竺	vu	ve
伫	vu	ra
洙	vu	dv
纻	vu	sa
瞩	vu	oy
苎	vu	ca
麈	vu	gv
槠	vu	mo
舳	vu	vy
柷	vu	me
疰	vu	bv
杼	vu	ml
潴	vu	do
侏	vu	rv
翥	vu	lx
砫	vu	uv
躅	vu	zi
蠋	vu	ii
橥	vu	qm
瘃	vu	bn
𬣞	vu	ya
抓	vx	fv
髽	vx	at
拽	vk	fy
转	vr	iv
赚	vr	kn
专	vr	ad
砖	vr	uv
撰	vr	fb
篆	vr	vu
馔	vr	ub
颛	vr	er
僎	vr	rb
啭	vr	kv
瑑	vr	wu
䏝	vr	ov
装	vl	dy
状	vl	dq
撞	vl	fl
庄	vl	gt
妆	vl	dn
桩	vl	mt
壮	vl	du
追	vv	zk
坠	vv	et
锥	vv	jf
缀	vv	sy
骓	vv	mf
椎	vv	mf
隹	vv	rf
赘	vv	fr
缒	vv	sz
惴	vv	xe
准	vy	df
肫	vy	ot
谆	vy	yz
窀	vy	bt
衠	vy	ii
𬘯	vy	sz
桌	vo	lm
捉	vo	fr
啄	vo	kn
卓	vo	lu
浊	vo	di
灼	vo	hu
拙	vo	fi
斫	vo	uj
酌	vo	yu
叕	vo	yy
擢	vo	ff
濯	vo	df
镯	vo	ji
琢	vo	wn
涿	vo	dn
汋	vo	du
倬	vo	ru
茁	vo	ci
浞	vo	dr
椓	vo	mn
禚	vo	ph
诼	vo	yn
棁	vo	me
晫	vo	ou
䓬	vo	cu
䦃	vo	jo
𬸦	vo	fn
字	zi	bz
自	zi	po
子	zi	va
紫	zi	vx
资	zi	dr
籽	zi	mz
姿	zi	dn
滋	zi	dy
渍	zi	dr
梓	zi	mu
眦	zi	ob
姊	zi	np
嗞	zi	ky
咨	zi	dk
恣	zi	dx
赀	zi	vr
訾	zi	vk
髭	zi	ab
笫	zi	vp
粢	zi	dm
缁	zi	st
孖	zi	zz
孳	zi	bz
觜	zi	vy
龇	zi	vb
孜	zi	zw
滓	zi	du
辎	zi	it
淄	zi	dt
秭	zi	hp
镃	zi	jy
耔	zi	lz
嵫	zi	ey
鼒	zi	cv
虸	zi	iz
锱	zi	jt
趑	zi	tr
鲻	zi	at
鄑	zi	ye
总	zs	bx
宗	zs	bx
纵	zs	sr
棕	zs	mx
粽	zs	mx
踪	zs	zx
鬃	zs	ax
腙	zs	ox
疭	zs	br
倧	zs	rx
鬷	zs	aw
偬	zs	rx
走	zz	tr
揍	zz	ft
奏	zz	ft
邹	zz	de
陬	zz	ey
驺	zz	me
诹	zz	yy
鲰	zz	ay
鄹	zz	ee
组	zu	sq
足	zu	kr
族	zu	fu
租	zu	hq
阻	zu	eq
祖	zu	pq
俎	zu	rq
菹	zu	cq
镞	zu	ju
诅	zu	yq
崒	zu	eu
珇	zu	wq
钻	zr	jk
攥	zr	fx
纂	zr	vx
缵	zr	sr
躜	zr	zr
最	zv	oy
嘴	zv	ky
罪	zv	sf
醉	zv	yu
蕞	zv	cy
槜	zv	mn
尊	zy	bc
遵	zy	zc
樽	zy	mc
鳟	zy	ac
噂	zy	kc
撙	zy	fc
僔	zy	rc
嶟	zy	ec
𨱔	zy	jc
做	zo	rw
作	zo	rv
坐	zo	rt
左	zo	ug
座	zo	gt
佐	zo	rg
嘬	zo	ky
昨	zo	ov
唑	zo	kt
酢	zo	yv
祚	zo	pv
怍	zo	xv
阼	zo	ev
胙	zo	ov
捽	zo	fu
岞	zo	ev
