啊	aa	ka
阿	aa	ek
吖	aa	ky
锕	aa	ja
腌	aa	od
爱	ai	vy
哎	ai	ka
唉	ai	ky
艾	ai	ci
癌	ai	bu
挨	ai	fu
矮	ai	uw
哀	ai	wy
埃	ai	tu
碍	ai	uc
欸	ai	qy
砹	ai	ua
隘	ai	ey
瑷	ai	wa
暧	ai	oa
毐	ai	um
嗳	ai	ka
蔼	ai	ch
霭	ai	yh
锿	ai	ja
嗌	ai	ky
嫒	ai	na
叆	ai	ya
皑	ai	bj
按	an	fa
安	an	bn
案	an	bm
俺	an	rd
暗	an	oy
氨	an	qa
胺	an	oa
庵	an	gd
岸	an	ug
鞍	an	ga
黯	an	hy
铵	an	ja
桉	an	ma
唵	an	kd
谙	an	yy
埯	an	td
盦	an	my
垵	an	ta
犴	an	qg
鹌	an	nd
𩽾	an	ya
昂	ah	oe
卬	ah	ea
盎	ah	my
肮	ah	ok
奥	ao	dm
熬	ao	ha
嗷	ao	ka
凹	ao	aa
澳	ao	da
傲	ao	ra
敖	ao	wd
鳌	ao	ya
袄	ao	yy
螯	ao	ia
拗	ao	fy
坳	ao	ty
獒	ao	qa
媪	ao	nm
岙	ao	uy
翱	ao	yg
遨	ao	za
鏊	ao	ja
薁	ao	ca
懊	ao	xa
璈	ao	wa
鏖	ao	jl
骜	ao	ma
奡	ao	aa
隩	ao	ea
聱	ao	ea
廒	ao	ga
嶅	ao	ua
吧	ba	kb
把	ba	fb
八	ba	pd
巴	ba	ag
拔	ba	fb
罢	ba	sq
叭	ba	kb
爸	ba	fb
扒	ba	fb
靶	ba	gb
钯	ba	jb
霸	ba	yo
疤	ba	bb
芭	ba	cb
耙	ba	lb
灞	ba	db
坝	ba	tb
捌	ba	fb
粑	ba	mb
跋	ba	zb
魃	ba	gb
鲃	ba	yb
妭	ba	nb
鲅	ba	yb
菝	ba	cb
羓	ba	yb
胈	ba	ob
朳	ba	mb
笆	ba	vb
岜	ba	ub
蚆	ba	ib
白	bl	pa
摆	bl	fb
拜	bl	pa
百	bl	ab
掰	bl	fu
败	bl	bw
柏	bl	mb
佰	bl	rb
稗	bl	hb
捭	bl	fb
伯	bl	rb
版	bj	pf
班	bj	dw
半	bj	bf
板	bj	mf
般	bj	vu
办	bj	lb
搬	bj	fb
拌	bj	fb
斑	bj	ww
伴	bj	rb
瓣	bj	gx
扮	bj	ff
扳	bj	ff
绊	bj	sb
颁	bj	yf
坂	bj	tf
阪	bj	ef
钣	bj	jf
癍	bj	bb
攽	bj	wf
柈	bj	mb
瘢	bj	bb
昄	bj	of
湴	bj	db
靽	bj	gb
𨭉	bj	bj
帮	bh	jb
棒	bh	mf
榜	bh	mp
磅	bh	up
邦	bh	ef
绑	bh	sb
镑	bh	jp
傍	bh	rp
蚌	bh	if
浜	bh	db
谤	bh	yp
梆	bh	mb
膀	bh	op
搒	bh	fp
玤	bh	wf
蒡	bh	cp
塝	bh	tp
𠳐	bh	kb
包	bk	gs
宝	bk	by
报	bk	fy
保	bk	rd
爆	bk	hb
抱	bk	fb
薄	bk	cc
堡	bk	tb
曝	bk	ob
饱	bk	ub
煲	bk	hb
鲍	bk	yb
剥	bk	dl
暴	bk	ou
豹	bk	vu
刨	bk	db
褒	bk	wy
苞	bk	cb
胞	bk	ob
葆	bk	cb
鸨	bk	nu
炮	bk	hb
孢	bk	zb
雹	bk	yb
枹	bk	mb
龅	bk	ib
趵	bk	zu
褓	bk	yb
瀑	bk	db
被	bz	yp
背	bz	ob
倍	bz	rk
呗	bz	kb
杯	bz	mb
北	bz	ap
贝	bz	ad
备	bz	wt
悲	bz	xf
碑	bz	ub
辈	bz	if
钡	bz	jb
焙	bz	hk
邶	bz	eb
卑	bz	pa
悖	bz	xb
孛	bz	zb
蓓	bz	cb
陂	bz	ep
碚	bz	uk
琲	bz	wf
惫	bz	xb
褙	bz	yb
鹎	bz	nb
鞴	bz	gy
狈	bz	qb
棓	bz	mk
椑	bz	mb
糒	bz	my
臂	bz	ob
鐾	bz	jb
鞁	bz	gp
𬇙	bz	db
本	bf	aa
奔	bf	dc
笨	bf	vb
苯	bf	cb
畚	bf	sf
贲	bf	bh
锛	bf	jb
犇	bf	nn
坌	bf	tf
夯	bf	dl
倴	bf	rb
栟	bf	mb
崩	bg	up
蹦	bg	zb
泵	bg	uu
甭	bg	by
绷	bg	sp
嘣	bg	kb
迸	bg	zb
甏	bg	wp
琫	bg	wf
祊	bg	uf
镚	bg	jb
比	bi	bb
笔	bi	vm
逼	bi	zf
币	bi	pj
必	bi	dd
鼻	bi	zb
壁	bi	tb
彼	bi	xp
毕	bi	bu
避	bi	zb
碧	bi	ub
哔	bi	kb
闭	bi	mc
弊	bi	cb
璧	bi	wb
铋	bi	jb
敝	bi	wb
匕	bi	pg
毙	bi	bs
俾	bi	rb
鄙	bi	eh
婢	bi	nb
蔽	bi	cb
濞	bi	db
庇	bi	gb
畀	bi	tq
陛	bi	eb
弼	bi	bg
痹	bi	bb
吡	bi	kb
髀	bi	gb
妣	bi	nb
襞	bi	yb
屄	bi	ux
箅	bi	vb
滗	bi	db
庳	bi	gb
芘	bi	cb
嬖	bi	nb
沘	bi	db
毖	bi	bb
蓖	bi	cb
萆	bi	cb
裨	bi	yb
苾	bi	cb
愎	bi	xf
篦	bi	vb
荜	bi	cb
邲	bi	eb
皕	bi	bb
薜	bi	cb
跸	bi	zb
咇	bi	kb
珌	bi	wb
舭	bi	vb
辟	bi	xk
佖	bi	rb
赑	bi	bb
荸	bi	cb
诐	bi	yp
筚	bi	vb
秕	bi	hb
狴	bi	qb
佛	bi	rf
觱	bi	jx
馝	bi	xb
泌	bi	db
秘	bi	hb
鲾	bi	yf
坒	bi	bt
便	bm	rg
边	bm	zl
变	bm	wy
遍	bm	zb
编	bm	sb
贬	bm	bf
辩	bm	xx
扁	bm	hc
鞭	bm	gb
辨	bm	dx
蝙	bm	ib
卞	bm	dx
煸	bm	hb
弁	bm	cs
辫	bm	sx
匾	bm	kb
汴	bm	db
苄	bm	cb
昪	bm	ob
抃	bm	fb
笾	bm	vb
砭	bm	uf
鳊	bm	yb
萹	bm	cb
忭	bm	xb
碥	bm	ub
褊	bm	yb
𨚕	bm	be
𰻝	bd	zx
表	bc	fy
标	bc	mu
婊	bc	nb
飙	bc	fb
镖	bc	jp
彪	bc	hp
裱	bc	yb
膘	bc	op
杓	bc	mu
摽	bc	fp
鳔	bc	yp
镳	bc	jb
骉	bc	mm
熛	bc	hp
幖	bc	jp
骠	bc	mp
藨	bc	cb
儦	bc	rb
瀌	bc	db
俵	bc	rb
飑	bc	fb
瘭	bc	bp
脿	bc	ob
别	bx	dl
憋	bx	xb
鳖	bx	yb
瘪	bx	bl
蹩	bx	zb
癿	bx	bg
宾	bn	bb
斌	bn	ww
彬	bn	mu
髌	bn	gb
鬓	bn	ib
豳	bn	uu
滨	bn	db
邠	bn	ef
膑	bn	ob
缤	bn	sb
殡	bn	db
濒	bn	dp
摈	bn	fb
玢	bn	wf
傧	bn	rb
镔	bn	jb
槟	bn	mb
并	by	bk
病	by	bb
兵	by	qb
冰	by	du
饼	by	ub
柄	by	mb
丙	by	an
禀	by	du
屏	by	ub
秉	by	ha
炳	by	hb
昺	by	ob
蛃	by	ib
摒	by	fp
邴	by	eb
波	bo	dp
博	bo	uc
播	bo	ff
拨	bo	ff
铂	bo	jb
搏	bo	fc
钵	bo	jb
啵	bo	kb
驳	bo	my
勃	bo	lb
玻	bo	wp
脖	bo	ob
帛	bo	bj
跛	bo	zp
亳	bo	dq
箔	bo	vb
泊	bo	db
钹	bo	jb
渤	bo	db
僰	bo	rc
擘	bo	ub
镈	bo	jc
菠	bo	cb
浡	bo	db
舶	bo	vb
嶓	bo	uf
膊	bo	oc
哱	bo	kb
砵	bo	ub
卜	bo	ad
踣	bo	zk
簸	bo	vp
鹁	bo	nb
檗	bo	mb
鲌	bo	yb
蕃	bo	cf
艴	bo	fs
馞	bo	xb
袯	bo	yb
饽	bo	ub
礴	bo	ub
欂	bo	mb
𬭛	bo	jb
不	bu	ad
部	bu	ek
补	bu	yb
步	bu	vx
布	bu	ju
簿	bu	vc
钚	bu	jb
捕	bu	ff
卟	bu	kb
怖	bu	xb
晡	bu	of
埠	bu	tf
逋	bu	zf
哺	bu	kf
蔀	bu	cb
瓿	bu	wk
醭	bu	yd
埔	bu	tf
埗	bu	tb
𬷕	bu	nf
擦	ca	fi
嚓	ca	ki
才	cl	ap
菜	cl	cc
踩	cl	zc
猜	cl	qq
蔡	cl	cj
财	cl	bc
采	cl	mv
材	cl	mc
裁	cl	gy
彩	cl	pc
睬	cl	oc
偲	cl	rs
惨	cj	xc
餐	cj	uy
残	cj	dj
参	cj	sp
蚕	cj	it
粲	cj	my
灿	cj	hu
骖	cj	mc
惭	cj	xv
璨	cj	wc
黪	cj	hc
䅟	cj	hc
藏	ch	cg
仓	ch	re
舱	ch	vc
苍	ch	cc
沧	ch	dc
鸧	ch	nc
伧	ch	rc
草	ck	cz
曹	ck	oc
槽	ck	mc
操	ck	fz
艹	ck	aa
糙	ck	mz
屮	ck	aa
嘈	ck	kc
漕	ck	dc
芔	ck	cc
肏	ck	rr
艚	ck	vc
螬	ck	ic
𥕢	ck	uc
侧	ce	rz
测	ce	dz
册	ce	ka
策	ce	vc
厕	ce	iz
恻	ce	xz
𤭢	cz	wz
岑	cf	uj
涔	cf	dc
层	cg	uy
曾	cg	ob
蹭	cg	zc
噌	cg	kc
嶒	cg	uc
差	ia	yg
茶	ia	cm
查	ia	md
插	ia	fi
叉	ia	dy
侘	ia	rv
茬	ia	cz
镲	ia	ji
察	ia	bj
猹	ia	qi
搽	ia	fi
槎	ia	mi
岔	ia	uf
杈	ia	mi
檫	ia	mi
碴	ia	ui
姹	ia	nv
汊	ia	di
衩	ia	yi
锸	ia	ji
垞	ia	tv
诧	ia	yv
馇	ia	ui
刹	ia	du
喳	ia	ki
蹅	ia	zi
嵖	ia	ui
𥻗	ia	mi
拆	il	fi
柴	il	mc
钗	il	ji
豺	il	vc
虿	il	iw
侪	il	rq
瘥	il	bi
茝	il	ci
产	ij	dp
铲	ij	ji
馋	ij	ud
缠	ij	sl
禅	ij	ud
蝉	ij	id
掺	ij	fc
颤	ij	yd
搀	ij	fd
谗	ij	yd
浐	ij	di
婵	ij	nd
蟾	ij	iv
澶	ij	dd
觇	ij	jv
阐	ij	md
镡	ij	jt
躔	ij	zi
谄	ij	yj
襜	ij	yv
刬	ij	dj
辿	ij	zu
忏	ij	xq
瀍	ij	di
巉	ij	ui
韂	ij	gv
羼	ij	uu
廛	ij	gt
潺	ij	di
梴	ij	my
孱	ij	un
蒇	ij	cb
啴	ij	kd
单	ij	ba
骣	ij	mi
镵	ij	ji
旵	ij	ou
冁	ij	dv
儳	ij	ri
𬊤	ij	hd
唱	ih	ki
场	ih	ty
长	ih	pd
常	ih	jk
厂	ih	ap
尝	ih	dy
肠	ih	oy
昌	ih	oo
畅	ih	uy
偿	ih	ri
敞	ih	wu
娼	ih	ni
怅	ih	xi
鬯	ih	bk
倡	ih	ri
昶	ih	oy
猖	ih	qi
苌	ih	ci
嫦	ih	ni
氅	ih	mi
伥	ih	ri
鲳	ih	yi
菖	ih	ci
徜	ih	xu
裳	ih	yk
阊	ih	mi
鲿	ih	yi
惝	ih	xu
𬬮	ih	ji
超	ik	zv
抄	ik	fu
炒	ik	hu
朝	ik	ou
潮	ik	di
吵	ik	ku
钞	ik	ju
巢	ik	ig
嘲	ik	ki
焯	ik	hv
晁	ik	ov
怊	ik	xv
绰	ik	sv
弨	ik	gv
耖	ik	lu
车	ie	aa
扯	ie	fv
撤	ie	fw
彻	ie	xq
掣	ie	uv
澈	ie	dw
坼	ie	ti
尺	ie	ad
砗	ie	ui
㬚	ie	ow
陈	if	ed
趁	if	zp
臣	if	aa
沉	if	dj
辰	if	iy
尘	if	tx
琛	if	wm
抻	if	fu
嗔	if	kv
衬	if	yc
晨	if	oi
称	if	he
宸	if	bi
谶	if	yg
谌	if	yu
瞋	if	ov
忱	if	xg
梣	if	mc
煁	if	hu
榇	if	mq
龀	if	ib
疢	if	bh
棽	if	lj
碜	if	uc
郴	if	el
𬘭	if	sl
成	ig	gg
城	ig	ti
呈	ig	kw
乘	ig	pb
撑	ig	fv
橙	ig	md
程	ig	hi
秤	ig	hp
盛	ig	mi
承	ig	ad
诚	ig	yi
丞	ig	au
逞	ig	zi
澄	ig	dd
埕	ig	ti
惩	ig	xv
枨	ig	mi
骋	ig	mk
铖	ig	ji
澂	ig	dw
珵	ig	wi
琤	ig	wv
偁	ig	rr
蛏	ig	iu
赪	ig	iv
酲	ig	yi
宬	ig	bi
塍	ig	ot
柽	ig	mu
瞠	ig	ot
珹	ig	wi
牚	ig	dy
憕	ig	xd
晟	ig	oi
铛	ig	jd
裎	ig	yi
庱	ig	gl
吃	ii	kq
池	ii	dy
持	ii	fs
赤	ii	tb
迟	ii	zi
齿	ii	vk
翅	ii	vy
敕	ii	uw
痴	ii	bv
驰	ii	my
耻	ii	ev
嗤	ii	ki
豉	ii	dv
斥	ii	jd
蚩	ii	iu
螭	ii	il
叱	ii	kb
彳	ii	pa
炽	ii	hv
笞	ii	vt
哧	ii	ki
媸	ii	ni
饬	ii	ul
侈	ii	rd
弛	ii	gy
褫	ii	yh
魑	ii	gl
摛	ii	fl
鸱	ii	nd
啻	ii	kd
瘛	ii	bj
漦	ii	ui
墀	ii	tx
茌	ii	cu
匙	ii	bu
眵	ii	od
篪	ii	vh
傺	ii	rj
踟	ii	zv
胣	ii	oy
瓻	ii	wx
痓	ii	bv
𫄨	ii	sx
冲	is	dv
重	is	pa
充	is	dy
虫	is	ad
宠	is	bl
崇	is	uz
铳	is	jy
舂	is	fj
憧	is	xt
摏	is	fi
艟	is	vt
翀	is	yv
忡	is	xv
茺	is	ci
涌	is	dy
种	is	hv
珫	is	wi
漴	is	di
㳘	is	di
抽	ib	fy
丑	ib	aa
臭	ib	zq
愁	ib	xq
瞅	ib	oq
仇	ib	rj
筹	ib	vu
稠	ib	hv
酬	ib	yv
雠	ib	vv
俦	ib	ru
绸	ib	sv
畴	ib	tu
瘳	ib	bl
惆	ib	xv
杻	ib	mi
犨	ib	nv
帱	ib	ju
椆	ib	mv
踌	ib	zu
侴	ib	rd
出	iu	ck
处	iu	wb
除	iu	ey
初	iu	yd
楚	iu	mp
厨	iu	ic
触	iu	ij
褚	iu	yv
杵	iu	mw
锄	iu	jv
储	iu	rv
怵	iu	xu
雏	iu	iv
橱	iu	mi
畜	iu	tx
黜	iu	hi
刍	iu	dx
俶	iu	ru
础	iu	ui
楮	iu	mv
矗	iu	vv
亍	iu	ad
滁	iu	di
绌	iu	si
樗	iu	mk
憷	iu	xi
斶	iu	ji
搐	iu	fi
摴	iu	fk
躇	iu	zv
蜍	iu	iy
濋	iu	di
蹰	iu	zc
䝙	iu	vq
䢺	iu	ei
琡	iu	wu
𬺓	iu	ii
欻	iw	qy
踹	iy	ze
揣	iy	fe
搋	iy	fh
啜	iy	ku
穿	ir	xy
传	ir	rv
船	ir	vk
川	ir	pa
串	ir	aa
氚	ir	qi
喘	ir	ke
钏	ir	ji
椽	ir	mt
舛	ir	xf
遄	ir	ze
床	id	gm
创	id	dc
窗	id	xx
闯	id	mm
疮	id	bc
怆	id	xc
幢	id	jt
噇	id	kt
吹	iv	kq
锤	iv	ji
捶	iv	fi
垂	iv	pa
槌	iv	mv
炊	iv	hq
圌	iv	ke
棰	iv	mi
倕	iv	ri
陲	iv	ei
纯	ip	st
春	ip	of
蠢	ip	ii
唇	ip	ik
醇	ip	yx
椿	ip	mi
淳	ip	dx
蝽	ip	ii
鹑	ip	nx
莼	ip	ci
瑃	ip	wi
䲠	ip	yi
堾	ip	ti
𬭚	ip	jx
戳	io	gd
辍	io	iu
龊	io	iz
踔	io	zv
逴	io	zv
惙	io	xu
次	ci	dq
此	ci	vb
词	ci	ys
刺	ci	dc
赐	ci	by
磁	ci	uz
茨	ci	cc
呲	ci	kc
辞	ci	ux
雌	ci	vc
瓷	ci	wc
祠	ci	us
慈	ci	xz
泚	ci	dc
疵	ci	bc
伺	ci	rs
玼	ci	wc
糍	ci	mz
跐	ci	zc
茈	ci	cc
兹	ci	by
佽	ci	rc
鹚	ci	nz
莿	ci	cc
𫚖	ci	yc
从	cs	rr
葱	cs	cc
聪	cs	ez
丛	cs	ac
琮	cs	wz
骢	cs	mx
悰	cs	xz
枞	cs	mc
璁	cs	wc
匆	cs	gp
淙	cs	dz
熜	cs	hc
囱	cs	ph
苁	cs	cc
凑	cb	dz
腠	cb	oz
辏	cb	iz
粗	cu	mq
醋	cu	yx
促	cu	rz
簇	cu	vz
蹙	cu	zq
蹴	cu	zj
徂	cu	xq
猝	cu	qz
殂	cu	dq
卒	cu	wu
蔟	cu	cz
窜	cr	xi
蹿	cr	zc
汆	cr	ru
篡	cr	vs
爨	cr	hd
攒	cr	fz
撺	cr	fc
镩	cr	jc
催	cv	rc
崔	cv	uv
脆	cv	ow
翠	cv	yz
萃	cv	cz
啐	cv	kz
摧	cv	fc
淬	cv	dz
粹	cv	mz
毳	cv	mm
璀	cv	wc
悴	cv	xz
瘁	cv	bz
漼	cv	dc
缞	cv	su
榱	cv	mu
寸	cp	ad
存	cp	uz
村	cp	mc
邨	cp	et
皴	cp	pj
忖	cp	xc
错	co	jx
搓	co	fi
挫	co	fz
锉	co	jz
措	co	fx
厝	co	ix
撮	co	fz
蹉	co	zi
矬	co	uz
痤	co	bz
瑳	co	wi
嵯	co	ui
鹾	co	li
磋	co	ui
脞	co	oz
棤	co	mx
莝	co	cz
大	da	ad
打	da	fd
答	da	vh
达	da	zd
搭	da	fd
哒	da	kd
妲	da	nd
嗒	da	kd
鞑	da	gd
怛	da	xd
沓	da	ou
炟	da	hd
跶	da	zd
笪	da	vd
耷	da	ed
靼	da	gd
垯	da	td
溚	da	dd
瘩	da	bd
褡	da	yd
荙	da	cd
鿎	da	ud
𨱏	da	jd
𫟼	da	jd
带	dl	jb
代	dl	ry
待	dl	xs
呆	dl	km
戴	dl	gg
贷	dl	bd
袋	dl	yd
黛	dl	hd
逮	dl	zl
岱	dl	ud
殆	dl	dt
迨	dl	zt
呔	dl	kt
歹	dl	ad
玳	dl	wd
傣	dl	rt
怠	dl	sx
绐	dl	st
埭	dl	tl
轪	dl	id
骀	dl	mt
叇	dl	yd
垈	dl	td
但	dj	rd
蛋	dj	ip
弹	dj	gd
淡	dj	dy
丹	dj	pd
氮	dj	qy
胆	dj	od
担	dj	fd
旦	dj	oa
啖	dj	ky
掸	dj	fd
澹	dj	dv
亶	dj	wd
石	dj	kp
诞	dj	yy
耽	dj	eg
惮	dj	xd
疍	dj	pd
儋	dj	rv
聃	dj	er
殚	dj	dd
箪	dj	vd
憺	dj	xv
瘅	dj	bd
膻	dj	od
眈	dj	og
萏	dj	cj
赕	dj	by
郸	dj	ed
疸	dj	bd
𫢸	dj	rd
𬘘	dj	sg
当	dh	xx
党	dh	xx
档	dh	md
挡	dh	fd
荡	dh	ct
裆	dh	yd
宕	dh	bu
砀	dh	uy
凼	dh	ku
珰	dh	wd
谠	dh	yd
菪	dh	cd
垱	dh	td
筜	dh	vd
𣗋	dh	md
𬍡	dh	yt
到	dk	dv
道	dk	zu
刀	dk	gp
倒	dk	rd
岛	dk	nu
导	dk	cs
盗	dk	mc
叨	dk	kd
氘	dk	qp
稻	dk	hj
捣	dk	fd
纛	dk	dx
悼	dk	xv
蹈	dk	zj
祷	dk	uu
捯	dk	fd
忉	dk	xd
舠	dk	vd
鱽	dk	yd
的	de	bu
得	de	xc
地	de	ty
德	de	xx
锝	de	jc
嘚	de	kd
扽	df	ft
等	dg	vs
灯	dg	hd
登	dg	dd
邓	dg	ey
蹬	dg	zd
凳	dg	jd
瞪	dg	od
噔	dg	kd
镫	dg	jd
戥	dg	gx
磴	dg	ud
嶝	dg	ud
璒	dg	wd
第	di	vp
低	di	rd
滴	di	dd
底	di	gd
帝	di	jb
迪	di	zy
敌	di	wu
蒂	di	cd
抵	di	fd
笛	di	vy
递	di	zd
弟	di	bp
狄	di	qh
氐	di	pd
镝	di	jd
骶	di	gd
嫡	di	nd
棣	di	ml
堤	di	tu
邸	di	ed
碲	di	ud
嘀	di	kd
睇	di	od
禘	di	ud
谛	di	yd
籴	di	rm
鞮	di	gu
砥	di	ud
涤	di	dt
菂	di	cd
荻	di	cd
诋	di	yd
觌	di	jm
娣	di	nd
羝	di	yd
杕	di	md
柢	di	md
翟	di	yv
髢	di	iy
坻	di	td
茋	di	cd
缔	di	sd
踶	di	zu
媂	di	nd
提	di	fu
蹢	di	zd
玓	di	wu
䃅	di	ud
䗖	di	id
𤧛	di	wd
𬱖	di	yy
嗲	dw	kd
点	dm	dv
店	dm	gv
电	dm	ag
垫	dm	tv
碘	dm	ud
殿	dm	ug
颠	dm	yv
典	dm	ba
滇	dm	dv
甸	dm	gt
掂	dm	fd
簟	dm	vt
癫	dm	bd
巅	dm	ud
奠	dm	dq
靛	dm	qd
钿	dm	jt
踮	dm	zd
佃	dm	rt
玷	dm	wv
淀	dm	dd
惦	dm	xd
坫	dm	tv
癜	dm	bd
扂	dm	hv
阽	dm	ev
琔	dm	wd
掉	dc	fv
调	dc	yv
吊	dc	kj
屌	dc	ud
叼	dc	kd
钓	dc	ju
雕	dc	vv
刁	dc	ga
貂	dc	vv
凋	dc	dv
鲷	dc	yv
碉	dc	uv
铫	dc	jv
窎	dc	xn
铞	dc	jd
汈	dc	dd
跌	dx	zu
爹	dx	fd
叠	dx	qr
碟	dx	um
蝶	dx	im
迭	dx	zu
谍	dx	ym
牒	dx	pm
昳	dx	ou
鲽	dx	ym
楪	dx	mm
喋	dx	km
堞	dx	tm
瓞	dx	gu
耋	dx	lv
垤	dx	tv
绖	dx	sv
蹀	dx	zm
𫶇	dx	ud
定	dy	bp
顶	dy	dy
丁	dy	aa
盯	dy	od
订	dy	yd
钉	dy	jd
叮	dy	kd
鼎	dy	oa
町	dy	td
碇	dy	ud
腚	dy	od
锭	dy	jd
玎	dy	wd
啶	dy	kd
酊	dy	yd
仃	dy	rd
疔	dy	bd
耵	dy	ed
萣	dy	cd
丢	dq	pq
铥	dq	jd
懂	ds	xd
动	ds	ly
东	ds	ad
洞	ds	dt
冻	ds	dd
冬	ds	wd
董	ds	cv
栋	ds	md
咚	ds	kd
氡	ds	qd
侗	ds	rt
鸫	ds	nd
胴	ds	ot
峒	ds	ut
恫	ds	xt
硐	ds	ut
岽	ds	ud
垌	ds	tt
胨	ds	od
𬟽	ds	id
都	db	ev
斗	db	du
抖	db	fd
豆	db	aa
逗	db	zd
兜	db	ek
痘	db	bd
陡	db	ez
窦	db	xm
读	db	ym
蔸	db	cd
蚪	db	id
钭	db	jd
篼	db	vd
度	du	gy
赌	du	bv
毒	du	fm
堵	du	tv
杜	du	mt
独	du	qi
渡	du	dd
督	du	ou
肚	du	ot
镀	du	jd
嘟	du	kd
笃	du	vm
睹	du	ov
蠹	du	ai
妒	du	nh
犊	du	nm
渎	du	dm
椟	du	mm
牍	du	pm
阇	du	mv
厾	du	yq
芏	du	ct
黩	du	hm
髑	du	gi
𬭊	du	jd
端	dr	le
段	dr	ud
短	dr	ud
断	dr	ja
椴	dr	md
锻	dr	jd
缎	dr	sd
耑	dr	ue
煅	dr	hd
塅	dr	td
簖	dr	vd
瑖	dr	wd
对	dv	cy
队	dv	er
怼	dv	xd
堆	dv	tv
兑	dv	bx
碓	dv	uv
祋	dv	uu
㨃	dv	fx
吨	dp	kt
蹲	dp	zz
盾	dp	po
顿	dp	yt
炖	dp	ht
惇	dp	xx
钝	dp	jt
墩	dp	td
遁	dp	zd
敦	dp	wx
趸	dp	zw
囤	dp	kt
盹	dp	ot
沌	dp	dt
镦	dp	jd
礅	dp	ud
蹾	dp	zd
砘	dp	ut
多	do	xx
躲	do	ud
哆	do	kd
夺	do	dc
剁	do	dd
朵	do	mj
堕	do	td
舵	do	vt
跺	do	zd
铎	do	jf
踱	do	zd
惰	do	xo
垛	do	td
咄	do	ki
掇	do	fu
埵	do	ti
亸	do	dx
驮	do	md
哚	do	kd
剟	do	du
裰	do	yu
饳	do	ui
㙍	do	tv
额	ee	yk
恶	ee	xy
呃	ee	ke
俄	ee	rw
饿	ee	uw
鹅	ee	nw
厄	ee	ie
讹	ee	yh
鳄	ee	ye
鄂	ee	ee
娥	ee	nw
腭	ee	oe
蛾	ee	iw
颚	ee	ye
锇	ee	jw
扼	ee	fe
莪	ee	cw
轭	ee	ie
萼	ee	ce
遏	ee	zh
谔	ee	ye
屙	ee	ua
鹗	ee	ne
愕	ee	xe
锷	ee	je
峨	ee	uw
涐	ee	dw
垩	ee	ty
噩	ee	wk
崿	ee	ue
婀	ee	na
哦	ee	kw
姶	ee	nh
苊	ee	ce
堨	ee	th
𥔲	ee	ue
𫫇	ee	ke
诶	ei	yu
嗯	en	ke
恩	en	xy
摁	en	fe
蒽	en	ce
而	er	aa
二	er	aa
儿	er	pg
耳	er	aa
尔	er	dx
贰	er	by
饵	er	ue
迩	er	ze
铒	er	je
珥	er	we
鸸	er	ne
洱	er	de
鲕	er	ye
耏	er	pe
陑	er	ee
咡	er	ke
发	fa	ay
法	fa	dq
伐	fa	rg
罚	fa	sd
阀	fa	mf
乏	fa	pv
筏	fa	vf
珐	fa	wq
垡	fa	tf
砝	fa	uq
反	fj	py
饭	fj	uf
翻	fj	yf
犯	fj	qe
范	fj	ce
泛	fj	df
凡	fj	dj
番	fj	tb
烦	fj	hy
返	fj	zf
帆	fj	jf
藩	fj	cf
繁	fj	sm
梵	fj	fl
樊	fj	dm
贩	fj	bf
钒	fj	jf
矾	fj	uf
幡	fj	jf
燔	fj	hf
氾	fj	de
璠	fj	wf
蘩	fj	cf
蹯	fj	zf
畈	fj	tf
墦	fj	tf
𫔍	fj	jf
𬸪	fj	nf
放	fh	wf
方	fh	dg
防	fh	ef
房	fh	hf
仿	fh	rf
坊	fh	tf
芳	fh	cf
访	fh	yf
钫	fh	jf
昉	fh	of
纺	fh	sf
枋	fh	mf
鲂	fh	yf
妨	fh	nf
舫	fh	vf
肪	fh	of
蚄	fh	if
邡	fh	ef
牥	fh	nf
非	fz	aa
费	fz	bf
飞	fz	yd
肺	fz	of
废	fz	gf
肥	fz	ob
菲	fz	cf
妃	fz	nj
匪	fz	kf
绯	fz	sf
斐	fz	wf
吠	fz	kq
沸	fz	df
霏	fz	yf
啡	fz	kf
腓	fz	of
榧	fz	mf
扉	fz	hf
淝	fz	df
蜚	fz	if
朏	fz	oi
镄	fz	jf
诽	fz	yf
痱	fz	bf
翡	fz	yf
狒	fz	qf
鲱	fz	yf
悱	fz	xf
芾	fz	cf
棐	fz	mf
剕	fz	df
篚	fz	vf
𬴂	fz	mf
分	ff	bd
粉	ff	mf
份	ff	rf
坟	ff	tw
芬	ff	cf
粪	ff	mg
焚	ff	hl
酚	ff	yf
汾	ff	df
忿	ff	xf
愤	ff	xb
奋	ff	dt
偾	ff	rb
纷	ff	sf
氛	ff	qf
棻	ff	cm
吩	ff	kf
棼	ff	fl
鲼	ff	yb
瀵	ff	dg
翂	ff	yf
坋	ff	tf
鼢	ff	uf
豮	ff	ub
𣸣	ff	db
风	fg	ji
封	fg	cg
冯	fg	dm
峰	fg	uf
疯	fg	bf
缝	fg	sf
奉	fg	ff
逢	fg	zf
锋	fg	jf
丰	fg	aa
凤	fg	jy
蜂	fg	if
枫	fg	mf
俸	fg	rf
沣	fg	df
讽	fg	yf
葑	fg	cf
沨	fg	df
烽	fg	hf
酆	fg	ed
砜	fg	uf
唪	fg	kf
崶	fg	uf
赗	fg	bm
浲	fg	df
否	fb	kb
缶	fb	pa
负	fu	db
附	fu	ef
服	fu	oy
副	fu	df
付	fu	rc
福	fu	uf
府	fu	gf
复	fu	pw
夫	fu	ad
富	fu	bf
赴	fu	zb
父	fu	bi
氟	fu	qf
扶	fu	ff
弗	fu	aa
赋	fu	bw
符	fu	vf
斧	fu	fj
伏	fu	rq
幅	fu	jf
敷	fu	wf
芙	fu	cf
傅	fu	rc
釜	fu	fa
腹	fu	of
浮	fu	df
辅	fu	if
妇	fu	nx
拂	fu	ff
甫	fu	ad
覆	fu	xf
抚	fu	fw
缚	fu	sc
腐	fu	gr
俘	fu	rf
俯	fu	rf
腑	fu	of
辐	fu	if
孚	fu	vz
阜	fu	pu
孵	fu	lf
凫	fu	jn
蝠	fu	if
肤	fu	of
芣	fu	cb
祓	fu	ub
脯	fu	of
苻	fu	cf
黼	fu	fb
鄜	fu	el
馥	fu	hf
涪	fu	dk
桴	fu	mf
黻	fu	bb
麸	fu	mf
拊	fu	ff
郛	fu	ef
莩	fu	cf
玞	fu	wf
簠	fu	vf
绂	fu	sb
宓	fu	bb
跗	fu	zf
茯	fu	cf
赙	fu	bc
趺	fu	zf
茀	fu	cf
蝮	fu	if
稃	fu	hf
怫	fu	xf
匐	fu	gf
呋	fu	kf
罘	fu	sb
驸	fu	mf
袱	fu	yf
洑	fu	df
榑	fu	mc
鲋	fu	yf
菔	fu	cf
滏	fu	df
咐	fu	kf
幞	fu	jd
绋	fu	sf
蚨	fu	if
韨	fu	wb
琈	fu	wf
垺	fu	tf
讣	fu	yb
蜉	fu	if
砆	fu	uf
㕮	fu	kf
㳇	fu	df
𫓧	fu	jf
𫖯	fu	yv
尬	ga	yj
嘎	ga	kg
噶	ga	kg
伽	ga	rj
尕	ga	xn
钆	ga	jg
咖	ga	kj
旮	ga	jo
尜	ga	xx
轧	ga	ig
戛	ga	ag
该	gl	yh
改	gl	wj
盖	gl	my
钙	gl	jg
概	gl	mj
丐	gl	ag
垓	gl	th
陔	gl	eh
溉	gl	dj
赅	gl	bh
荄	gl	ch
戤	gl	gy
晐	gl	oh
𬮿	gl	eq
感	gj	xx
干	gj	aa
敢	gj	we
肝	gj	og
杆	gj	mg
赶	gj	zg
甘	gj	aa
柑	gj	mg
淦	gj	dj
苷	gj	cg
赣	gj	dd
擀	gj	fg
绀	gj	sg
竿	gj	vg
尴	gj	yj
橄	gj	mg
秆	gj	hg
玕	gj	wg
鳡	gj	yg
酐	gj	yg
矸	gj	ug
疳	gj	bg
泔	gj	dg
坩	gj	tg
旰	gj	og
澉	gj	dg
虷	gj	ig
㽏	gj	gq
刚	gh	dg
岗	gh	ug
港	gh	dx
杠	gh	mg
缸	gh	fg
钢	gh	jg
纲	gh	sg
肛	gh	og
冈	gh	ki
罡	gh	sv
矼	gh	ug
扛	gh	fg
戆	gh	xb
冮	gh	dg
堽	gh	tg
筻	gh	vg
㭎	gh	mg
鿍	gh	tf
高	gk	wk
搞	gk	fg
稿	gk	hg
告	gk	kn
膏	gk	og
糕	gk	mg
镐	gk	jg
诰	gk	yg
皋	gk	bu
锆	gk	jg
郜	gk	eg
缟	gk	sg
藁	gk	cm
杲	gk	om
篙	gk	vg
睾	gk	ps
槔	gk	mg
羔	gk	dy
槁	gk	mg
筶	gk	vg
个	ge	ra
各	ge	wk
哥	ge	kd
歌	ge	qg
格	ge	mg
割	ge	dh
隔	ge	eg
咯	ge	kg
搁	ge	fg
戈	ge	ad
葛	ge	ch
阁	ge	mg
铬	ge	jg
鸽	ge	nh
镉	ge	jg
嗝	ge	kg
革	ge	aa
硌	ge	ug
膈	ge	og
鬲	ge	aa
胳	ge	og
蛤	ge	ih
骼	ge	gg
舸	ge	vk
圪	ge	tq
疙	ge	bq
饹	ge	ug
滆	ge	dg
袼	ge	yg
哿	ge	kj
仡	ge	rq
合	ge	rk
虼	ge	iq
塥	ge	tg
给	gz	sh
跟	gf	zg
根	gf	mg
哏	gf	kg
艮	gf	ad
亘	gf	aa
茛	gf	cg
更	gg	ad
梗	gg	mg
羹	gg	gm
耿	gg	eh
耕	gg	lj
庚	gg	gd
埂	gg	tg
哽	gg	kg
赓	gg	bg
暅	gg	oh
鲠	gg	yg
浭	gg	dg
颈	gg	yg
绠	gg	sg
鹒	gg	ng
𬒔	gg	uk
共	gs	bc
供	gs	rg
弓	gs	ag
工	gs	aa
公	gs	sb
宫	gs	bl
攻	gs	gw
功	gs	gl
拱	gs	fg
龚	gs	lg
汞	gs	gu
贡	gs	bg
恭	gs	gx
躬	gs	ug
巩	gs	gf
肱	gs	oh
觥	gs	jg
蚣	gs	ig
珙	gs	wg
䢼	gs	eg
硔	gs	ug
狗	gb	qj
够	gb	jd
勾	gb	gs
钩	gb	jg
沟	gb	dg
购	gb	bg
苟	gb	cj
构	gb	mg
垢	gb	th
篝	gb	vg
遘	gb	zg
彀	gb	ug
觏	gb	jr
诟	gb	yh
媾	gb	ng
枸	gb	mj
姤	gb	nh
雊	gb	vj
鞲	gb	gg
笱	gb	vj
句	gb	gk
缑	gb	sh
佝	gb	rj
岣	gb	uj
耇	gb	lj
故	gu	wg
股	gu	ou
古	gu	uk
鼓	gu	vd
谷	gu	bk
骨	gu	go
顾	gu	ye
钴	gu	jg
雇	gu	hv
孤	gu	zg
固	gu	kg
菇	gu	cg
蛊	gu	im
姑	gu	ng
箍	gu	vz
估	gu	rg
咕	gu	kg
瞽	gu	og
沽	gu	dg
菰	gu	cg
诂	gu	yg
辜	gu	ux
毂	gu	iu
觚	gu	jg
榖	gu	hu
贾	gu	bx
酤	gu	yg
锢	gu	jg
崮	gu	ug
堌	gu	tg
蛄	gu	ig
罟	gu	sg
汩	gu	do
鹘	gu	gn
轱	gu	ig
嘏	gu	gy
牯	gu	ng
梏	gu	mg
鲴	gu	yg
呱	gu	kg
鹄	gu	ng
痼	gu	bg
鸪	gu	ng
羖	gu	yu
瀔	gu	dg
臌	gu	og
馉	gu	ug
牿	gu	ng
蓇	gu	cg
𦙶	gu	og
挂	gw	fg
刮	gw	du
瓜	gw	pd
卦	gw	bg
寡	gw	bf
剐	gw	dg
胍	gw	og
褂	gw	yg
栝	gw	mu
鸹	gw	nu
诖	gw	yg
怪	gy	xu
乖	gy	pb
拐	gy	fl
夬	gy	ad
掴	gy	fg
管	gr	vg
关	gr	bt
官	gr	bg
观	gr	jy
馆	gr	ug
冠	gr	bc
灌	gr	dv
罐	gr	fv
棺	gr	mg
贯	gr	bm
惯	gr	xg
毌	gr	aa
倌	gr	rg
掼	gr	fg
琯	gr	wg
瓘	gr	wv
祼	gr	ug
鹳	gr	nv
鳏	gr	yd
筦	gr	vw
爟	gr	hg
盥	gr	jm
涫	gr	dg
纶	gr	sl
莞	gr	cw
鳤	gr	yg
蒄	gr	cg
光	gd	ea
广	gd	dp
逛	gd	zk
咣	gd	kg
洸	gd	dg
桄	gd	mg
犷	gd	qg
胱	gd	og
垙	gd	tg
珖	gd	wg
𨐈	gd	ig
贵	gv	ba
归	gv	ax
鬼	gv	pd
柜	gv	mj
跪	gv	zw
轨	gv	ij
硅	gv	ug
龟	gv	dd
圭	gv	tt
桂	gv	mg
规	gv	fj
诡	gv	yw
珪	gv	wg
瑰	gv	wg
癸	gv	dt
簋	gv	vm
妫	gv	nw
鲑	gv	yg
邽	gv	eg
刿	gv	ds
晷	gv	oj
闺	gv	mg
桧	gv	mh
刽	gv	dh
鳜	gv	yj
鬶	gv	gg
宄	gv	bj
庋	gv	gv
匦	gv	kg
皈	gv	bf
炅	gv	oh
姽	gv	nw
筀	gv	vg
滚	gp	dg
棍	gp	mk
鲧	gp	yx
辊	gp	ik
衮	gp	ly
绲	gp	sk
磙	gp	ug
过	go	zc
国	go	ky
锅	go	jg
郭	go	ex
果	go	ad
裹	go	wy
粿	go	mg
虢	go	hc
椁	go	mx
馘	go	uh
腘	go	og
崞	go	ux
馃	go	ug
呙	go	kn
帼	go	jg
蝈	go	ig
聒	go	eu
蜾	go	ig
涡	go	dg
埚	go	tg
𬇹	go	dg
哈	ha	kh
铪	ha	jh
还	hl	zb
海	hl	dm
嗨	hl	kh
害	hl	bk
氦	hl	qh
孩	hl	zh
亥	hl	dd
嗐	hl	kh
醢	hl	ym
骇	hl	mh
骸	hl	gh
咳	hl	kh
咍	hl	kt
胲	hl	oh
含	hj	kj
喊	hj	kx
韩	hj	uw
汉	hj	dy
汗	hj	dg
寒	hj	bd
函	hj	ku
邯	hj	eg
憨	hj	xg
焊	hj	hh
旱	hj	og
焓	hj	hh
悍	hj	xh
罕	hj	bg
涵	hj	dh
憾	hj	xg
酣	hj	yg
翰	hj	yu
撼	hj	fg
瀚	hj	dh
颔	hj	yh
捍	hj	fh
晗	hj	oh
蚶	hj	ig
鼾	hj	bg
扞	hj	fg
菡	hj	ch
邗	hj	eg
琀	hj	wh
暵	hj	oh
顸	hj	gy
撖	hj	fg
浛	hj	dh
㘎	hj	kk
垾	hj	th
崡	hj	uh
嵅	hj	ux
蔊	hj	ch
行	hh	xd
杭	hh	mk
航	hh	vk
沆	hh	dk
颃	hh	ky
绗	hh	sx
巷	hh	gs
吭	hh	kk
好	hk	nz
号	hk	kk
薅	hk	cr
耗	hk	lm
浩	hk	dg
豪	hk	ub
壕	hk	th
郝	hk	ei
嚎	hk	kh
蚝	hk	im
皓	hk	bg
毫	hk	mb
蒿	hk	cg
昊	hk	ot
皞	hk	bg
濠	hk	dh
灏	hk	dy
貉	hk	vg
鄗	hk	eg
淏	hk	dh
嗥	hk	kg
颢	hk	yj
嚆	hk	kg
和	he	hk
喝	he	kh
核	he	mh
盒	he	mh
何	he	rk
河	he	dk
呵	he	kk
赫	he	ii
贺	he	bj
鹤	he	nv
禾	he	pd
荷	he	ch
阖	he	mh
龁	he	iq
嗬	he	kh
褐	he	yh
曷	he	oa
颌	he	yh
郃	he	eh
盍	he	mq
涸	he	dg
诃	he	yk
鹖	he	nh
劾	he	lh
壑	he	ty
纥	he	sq
盉	he	hm
吓	he	kx
龢	he	hc
熇	he	hg
菏	he	ch
饸	he	uh
翮	he	yg
翯	he	yg
阂	he	mh
垎	he	tg
隺	he	bv
鞨	he	gh
𬌗	he	yh
黑	hz	ad
嘿	hz	kh
𬭶	hz	jh
很	hf	xg
恨	hf	xg
狠	hf	qg
痕	hf	bg
𬣳	hf	yg
哼	hg	kh
横	hg	mh
恒	hg	xg
衡	hg	xd
亨	hg	wl
珩	hg	wx
桁	hg	mx
蘅	hg	ch
鸻	hg	nx
姮	hg	ng
堼	hg	tf
红	hs	sg
烘	hs	hg
哄	hs	kg
宏	hs	bh
轰	hs	iu
虹	hs	ig
鸿	hs	dn
洪	hs	dg
薨	hs	cs
弘	hs	gs
泓	hs	dh
纮	hs	sh
闳	hs	ms
吽	hs	kn
竑	hs	lh
黉	hs	dh
翃	hs	yh
訇	hs	gy
蕻	hs	cg
唝	hs	kg
讧	hs	yg
荭	hs	ch
玒	hs	wg
谼	hs	gg
𫟹	hs	jg
𬭎	hs	jh
后	hb	pk
厚	hb	iz
吼	hb	kk
侯	hb	ru
猴	hb	qh
喉	hb	kh
候	hb	ru
齁	hb	bj
鲎	hb	dy
堠	hb	th
骺	hb	gh
垕	hb	th
逅	hb	zh
糇	hb	mh
瘊	hb	bh
篌	hb	vh
郈	hb	eh
鲘	hb	yh
𬭤	hb	jh
壶	hu	uy
户	hu	dp
湖	hu	dh
胡	hu	og
虎	hu	hj
乎	hu	pa
糊	hu	mh
互	hu	aa
呼	hu	kh
沪	hu	dh
护	hu	fh
忽	hu	xw
弧	hu	gg
狐	hu	qg
唬	hu	kh
斛	hu	jd
瑚	hu	wh
瓠	hu	gk
縠	hu	su
笏	hu	vw
煳	hu	hh
烀	hu	hh
鄠	hu	ek
葫	hu	ch
扈	hu	hb
惚	hu	xh
祜	hu	ug
怙	hu	xg
觳	hu	ju
岵	hu	ug
唿	hu	kh
冱	hu	dh
鹱	hu	ny
鳠	hu	yh
蝴	hu	ih
琥	hu	wh
淴	hu	dh
鹕	hu	nh
醐	hu	yh
槲	hu	mh
滹	hu	dh
囫	hu	kw
戽	hu	hd
嫭	hu	nh
轷	hu	ih
浒	hu	dx
猢	hu	qh
昈	hu	oh
昒	hu	ow
花	hw	ch
化	hw	rb
画	hw	ak
话	hw	yu
滑	hw	dg
华	hw	uh
划	hw	dg
哗	hw	kh
桦	hw	mh
婳	hw	nh
猾	hw	qg
砉	hw	fu
铧	hw	jh
骅	hw	mh
觟	hw	jg
坏	hy	tb
怀	hy	xb
淮	hy	dv
踝	hy	zg
槐	hy	mg
徊	hy	xh
换	hr	fh
环	hr	wb
患	hr	xi
幻	hr	yg
缓	hr	sy
唤	hr	kh
欢	hr	yq
嬛	hr	nh
桓	hr	mg
浣	hr	dw
寰	hr	bh
獾	hr	qv
焕	hr	hh
涣	hr	dh
洹	hr	dg
圜	hr	kh
豢	hr	ju
郇	hr	ex
鲩	hr	yw
宦	hr	bi
奂	hr	dd
萑	hr	cv
逭	hr	zg
擐	hr	fh
缳	hr	sh
鹮	hr	nh
澴	hr	dh
镮	hr	jh
漶	hr	dh
鬟	hr	ih
睆	hr	ow
痪	hr	bh
貆	hr	vg
峘	hr	ug
锾	hr	jy
㬊	hr	oy
荁	hr	cg
𤩽	hr	wx
𬘫	hr	sw
黄	hd	ad
慌	hd	xh
皇	hd	bw
晃	hd	og
荒	hd	ci
谎	hd	yh
簧	hd	vh
煌	hd	hh
篁	hd	vh
凰	hd	jh
幌	hd	jh
蝗	hd	ih
恍	hd	xg
滉	hd	dh
遑	hd	zh
潢	hd	dh
璜	hd	wh
磺	hd	uh
湟	hd	dh
肓	hd	ow
锽	hd	jh
徨	hd	xh
惶	hd	xh
鳇	hd	yh
隍	hd	eh
喤	hd	kh
艎	hd	vh
癀	hd	bh
蟥	hd	ih
媓	hd	nh
瑝	hd	wh
㿠	hd	bg
𨱑	hd	jh
会	hv	ry
回	hv	kk
灰	hv	hu
毁	hv	jy
汇	hv	dk
惠	hv	xh
茴	hv	ch
绘	hv	sh
挥	hv	fj
辉	hv	gj
悔	hv	xm
慧	hv	xh
喙	hv	kt
烩	hv	hh
晖	hv	oj
讳	hv	yw
恢	hv	xh
徽	hv	xw
虺	hv	iw
卉	hv	cu
秽	hv	hs
蕙	hv	ch
麾	hv	mm
诲	hv	ym
晦	hv	om
隳	hv	ex
恚	hv	xg
荟	hv	ch
洄	hv	dh
翚	hv	yj
浍	hv	dh
彗	hv	fx
贿	hv	by
翙	hv	ys
咴	hv	kh
珲	hv	wj
蛔	hv	ih
哕	hv	ks
诙	hv	yh
袆	hv	yw
橞	hv	mh
蟪	hv	ih
溃	hv	dg
烠	hv	hy
硊	hv	uw
㧑	hv	fw
𬤝	hv	yh
𬭬	hv	jh
混	hp	dk
魂	hp	gy
婚	hp	nh
荤	hp	cj
浑	hp	dj
昏	hp	ou
溷	hp	dh
阍	hp	mh
馄	hp	uk
诨	hp	yj
惛	hp	xh
碈	hp	uh
或	ho	gk
活	ho	du
火	ho	dd
货	ho	bh
获	ho	cq
霍	ho	yv
嚯	ho	kh
祸	ho	ug
豁	ho	gh
伙	ho	rh
惑	ho	xh
镬	ho	jy
藿	ho	ch
钬	ho	jh
濩	ho	dh
夥	ho	gd
嚄	ho	kh
蠖	ho	ih
攉	ho	fh
漷	ho	dg
劐	ho	dh
耠	ho	lh
佸	ho	ru
锪	ho	jh
㸌	ho	hh
𬴃	ho	mu
及	ji	nd
即	ji	eg
级	ji	sj
机	ji	mj
既	ji	gg
集	ji	mv
记	ji	yj
鸡	ji	ny
极	ji	mj
几	ji	py
季	ji	hz
肌	ji	oj
基	ji	tq
急	ji	xi
系	ji	ps
挤	ji	fq
继	ji	sa
剂	ji	dq
计	ji	yu
姬	ji	ni
寄	ji	bq
技	ji	fv
祭	ji	uy
吉	ji	ku
寂	ji	bu
击	ji	aa
籍	ji	vj
忌	ji	jx
纪	ji	sj
己	ji	ag
积	ji	hv
暨	ji	dj
箕	ji	vq
疾	ji	bu
脊	ji	od
辑	ji	ie
戟	ji	gu
激	ji	dj
济	ji	dq
矶	ji	uj
叽	ji	kj
迹	ji	zy
饥	ji	uj
棘	ji	cc
绩	ji	sz
冀	ji	bg
藉	ji	cj
蓟	ji	cd
际	ji	eu
妓	ji	nv
稷	ji	hw
汲	ji	dj
霁	ji	yq
亟	ji	aa
伋	ji	rj
赍	ji	bb
髻	ji	ij
鲫	ji	yj
殛	ji	dj
稽	ji	hv
奇	ji	dk
伎	ji	rv
嵴	ji	uj
偈	ji	rh
畸	ji	tq
圾	ji	tj
嫉	ji	nj
讥	ji	yj
笈	ji	vj
罽	ji	sd
唧	ji	kj
齑	ji	wa
乩	ji	gv
骥	ji	mg
芰	ji	cv
畿	ji	tg
戢	ji	ad
玑	ji	wj
笄	ji	vk
嵇	ji	hu
洎	ji	dz
楫	ji	me
垍	ji	tz
麂	ji	lj
羁	ji	sm
跻	ji	zq
跽	ji	zj
屐	ji	uv
蕺	ji	cg
姞	ji	nj
荠	ji	cq
觊	ji	jj
漈	ji	dj
缉	ji	se
悸	ji	xj
鲚	ji	yq
剞	ji	dq
觭	ji	jq
佶	ji	rj
掎	ji	fq
岌	ji	uj
惎	ji	qx
耤	ji	lx
芨	ji	cj
虮	ji	ij
瘠	ji	bj
期	ji	oq
蹐	ji	zj
犄	ji	nq
穄	ji	hj
堲	ji	tj
蒺	ji	cj
墼	ji	tu
瀱	ji	dd
鹡	ji	nj
鱾	ji	yj
㴔	ji	dj
徛	ji	xq
枅	ji	mk
𪟝	ji	lz
𫌀	ji	yz
𫓯	ji	jg
𫓹	ji	jq
𬯀	ji	eq
𬶨	ji	yj
𬶭	ji	yj
加	jw	lk
家	jw	bu
假	jw	rj
价	jw	rj
甲	jw	aa
架	jw	mj
夹	jw	fb
嫁	jw	nj
钾	jw	jj
佳	jw	rg
嘉	jw	uj
迦	jw	zj
驾	jw	mj
镓	jw	jj
痂	jw	bj
颊	jw	yj
荚	jw	cj
枷	jw	mj
葭	jw	cj
岬	jw	uj
珈	jw	wj
斝	jw	db
笳	jw	vj
郏	jw	ej
瘕	jw	bj
铗	jw	jj
稼	jw	hj
浃	jw	dj
茄	jw	cj
胛	jw	oj
槚	jw	mj
跏	jw	zj
蛱	jw	ij
袈	jw	yj
恝	jw	xd
泇	jw	dj
𬂩	jw	mj
间	jm	mo
见	jm	ag
剑	jm	da
件	jm	rn
键	jm	jj
兼	jm	bd
减	jm	dx
建	jm	zy
煎	jm	hq
捡	jm	fq
箭	jm	vq
剪	jm	dq
肩	jm	ho
简	jm	vj
尖	jm	xd
舰	jm	vj
贱	jm	bj
碱	jm	ux
健	jm	rj
歼	jm	dq
茧	jm	ci
监	jm	mv
荐	jm	cc
溅	jm	dj
渐	jm	dv
拣	jm	fd
检	jm	ma
谏	jm	yj
僭	jm	ro
奸	jm	ng
坚	jm	ty
鉴	jm	jv
笺	jm	vj
蹇	jm	bz
涧	jm	dj
践	jm	zj
睑	jm	oa
菅	jm	cg
艰	jm	yg
翦	jm	yq
俭	jm	ra
腱	jm	oj
柬	jm	ad
缄	jm	sx
笕	jm	vj
缣	jm	sj
锏	jm	jj
戋	jm	ad
鞬	jm	gj
謇	jm	by
湔	jm	dq
犍	jm	nj
踺	jm	zj
裥	jm	yj
槛	jm	mj
篯	jm	vq
蒹	jm	cj
搛	jm	fj
鲣	jm	yj
戬	jm	gj
鹣	jm	nj
楗	jm	mj
暕	jm	oj
枧	jm	mj
谫	jm	yj
毽	jm	mj
趼	jm	zk
饯	jm	uj
鞯	jm	gj
牮	jm	nd
鳒	jm	yj
𬣡	jm	yj
将	jd	dc
讲	jd	yj
奖	jd	dx
酱	jd	yx
姜	jd	ny
江	jd	dg
降	jd	ef
蒋	jd	cj
僵	jd	rj
匠	jd	jk
桨	jd	mx
浆	jd	ux
绛	jd	sf
犟	jd	nq
疆	jd	gj
缰	jd	sj
鳉	jd	yj
豇	jd	dg
洚	jd	df
强	jd	gs
耩	jd	lr
弶	jd	gj
糨	jd	mq
礓	jd	uj
茳	jd	cj
膙	jd	oq
叫	jc	kj
交	jc	li
较	jc	ij
教	jc	wx
脚	jc	oq
角	jc	dy
胶	jc	oj
浇	jc	dy
焦	jc	hv
缴	jc	sj
搅	jc	fj
嚼	jc	kc
椒	jc	mu
窖	jc	xg
鲛	jc	yj
娇	jc	nq
绞	jc	sj
跤	jc	zj
轿	jc	iq
矫	jc	uq
剿	jc	dg
蛟	jc	ij
骄	jc	mq
徼	jc	xj
礁	jc	uj
饺	jc	uj
蕉	jc	cj
铰	jc	jj
狡	jc	qj
皎	jc	bj
郊	jc	ej
湫	jc	dq
酵	jc	yx
滘	jc	dk
校	jc	mj
姣	jc	nj
鹪	jc	nj
醮	jc	yj
皦	jc	bj
觉	jc	dj
敫	jc	wf
艽	jc	cj
茭	jc	cj
峤	jc	uq
佼	jc	rj
璬	jc	wj
燋	jc	hj
侥	jc	ry
斠	jc	dg
皭	jc	bj
峧	jc	uj
藠	jc	cb
噍	jc	kj
漖	jc	dj
僬	jc	rj
恔	jc	xj
䴔	jc	nj
届	jx	uy
界	jx	tj
借	jx	rx
接	jx	fq
皆	jx	bb
解	jx	jn
节	jx	ce
姐	jx	nq
街	jx	ri
结	jx	sj
截	jx	gv
杰	jx	hm
劫	jx	lq
戒	jx	gc
阶	jx	ej
揭	jx	fh
介	jx	ra
蚧	jx	ij
捷	jx	fj
洁	jx	dj
芥	jx	cj
嗟	jx	ki
桀	jx	mf
诘	jx	yj
羯	jx	yh
竭	jx	lh
桔	jx	mj
颉	jx	yj
孑	jx	aa
疖	jx	be
诫	jx	yj
玠	jx	wj
碣	jx	uh
婕	jx	nj
疥	jx	bj
睫	jx	oj
絜	jx	sd
劼	jx	lj
秸	jx	hj
拮	jx	fj
檞	jx	mj
骱	jx	gj
湝	jx	dj
蜐	jx	ij
鲒	jx	yj
楷	jx	mj
讦	jx	yg
喈	jx	kj
悈	jx	xj
褯	jx	yx
岊	jx	ub
㛃	jx	nq
进	jn	zj
近	jn	zj
仅	jn	ry
金	jn	ra
斤	jn	pa
今	jn	ra
尽	jn	id
劲	jn	lg
紧	jn	sy
晋	jn	oy
筋	jn	vl
禁	jn	ul
锦	jn	jb
津	jn	dy
巾	jn	aa
浸	jn	dy
堇	jn	ca
谨	jn	yj
靳	jn	gj
槿	jn	mj
瑾	jn	wj
矜	jn	mj
衿	jn	yj
烬	jn	hj
襟	jn	yj
瑨	jn	wj
噤	jn	kj
溍	jn	dj
缙	jn	sj
觐	jn	jj
祲	jn	uy
妗	jn	nj
馑	jn	uj
浕	jn	dj
赆	jn	bj
荩	jn	cj
殣	jn	dj
珒	jn	wy
廑	jn	gj
琎	jn	wj
墐	jn	tj
卺	jn	ei
𬬱	jn	jj
经	jy	sg
竟	jy	le
精	jy	mq
镜	jy	jj
净	jy	dv
静	jy	qv
竞	jy	lx
景	jy	oj
京	jy	wx
敬	jy	wg
井	jy	aa
鲸	jy	yj
惊	jy	xj
警	jy	yj
境	jy	tj
茎	jy	cg
径	jy	xg
荆	jy	dk
靖	jy	lq
菁	jy	cq
晶	jy	oo
睛	jy	oq
璟	jy	wj
胫	jy	og
粳	jy	mg
肼	jy	oj
阱	jy	ej
旌	jy	fu
泾	jy	dg
丼	jy	jd
婧	jy	nq
竫	jy	lv
迳	jy	zg
腈	jy	oq
儆	jy	rj
憬	jy	xj
痉	jy	bg
倞	jy	rj
刭	jy	dg
靓	jy	jq
獍	jy	qj
兢	jy	kk
鼱	jy	uq
汫	jy	dj
璥	jy	wj
麖	jy	lj
猄	jy	qj
䴖	jy	nq
囧	js	kk
冏	js	kk
迥	js	zt
炯	js	hk
窘	js	xj
扃	js	hk
颎	js	yh
坰	js	tj
泂	js	dj
䌹	js	sh
𬳶	js	mj
就	jq	yj
酒	jq	dy
旧	jq	ao
救	jq	wq
九	jq	py
久	jq	pd
揪	jq	fq
鸠	jq	nj
灸	jq	hj
啾	jq	kq
玖	jq	wj
韭	jq	fa
纠	jq	sj
舅	jq	jn
究	jq	xj
咎	jq	ki
臼	jq	pa
鹫	jq	nj
厩	jq	ij
僦	jq	rj
柩	jq	mj
疚	jq	bj
氿	jq	dj
鬏	jq	iq
阄	jq	mg
赳	jq	zj
桕	jq	mj
㠇	jq	uj
据	ju	fj
剧	ju	dj
局	ju	uk
举	ju	df
距	ju	zj
聚	ju	ed
巨	ju	kk
居	ju	ug
狙	ju	qq
具	ju	ba
拒	ju	fj
菊	ju	cj
俱	ju	rj
锯	ju	jj
焗	ju	hj
橘	ju	mk
惧	ju	xj
矩	ju	uj
車	ju	aa
钜	ju	jj
鞠	ju	gj
遽	ju	zj
拘	ju	fj
沮	ju	dq
莒	ju	cl
驹	ju	mj
掬	ju	fj
踞	ju	zj
锔	ju	jj
苴	ju	cq
炬	ju	hj
琚	ju	wj
讵	ju	yj
咀	ju	kq
裾	ju	yj
鞫	ju	gy
椐	ju	mj
秬	ju	hj
屦	ju	ul
倨	ju	rj
雎	ju	qv
苣	ju	cj
娵	ju	nq
疽	ju	bq
榉	ju	mj
筥	ju	vl
蒟	ju	cj
窭	ju	xl
砠	ju	uq
醵	ju	yj
龃	ju	iq
崌	ju	uj
泃	ju	dj
踽	ju	zy
犋	ju	nj
岨	ju	uq
趄	ju	zq
澽	ju	dj
飓	ju	fj
岠	ju	uj
腒	ju	oj
弆	ju	cq
䴗	ju	in
𬶋	ju	yj
卷	jr	ef
捐	jr	fo
圈	jr	kj
绢	jr	so
涓	jr	do
娟	jr	no
倦	jr	rj
隽	jr	nv
狷	jr	qo
镌	jr	jj
蠲	jr	yu
鹃	jr	no
鄄	jr	et
眷	jr	of
焆	jr	ho
锩	jr	jj
桊	jr	jm
绝	jt	ss
决	jt	dd
撅	jt	fj
爵	jt	vc
倔	jt	rq
掘	jt	fq
厥	jt	ij
诀	jt	yd
蕨	jt	cj
玦	jt	wd
蹶	jt	zj
噘	jt	kj
崛	jt	uq
攫	jt	fj
珏	jt	wy
谲	jt	yk
橛	jt	mj
抉	jt	fd
傕	jt	rv
玃	jt	qj
爝	jt	hj
孓	jt	ad
桷	jt	mj
觖	jt	jd
矍	jt	oy
獗	jt	qj
镢	jt	jj
劂	jt	dj
砄	jt	ud
㵐	jt	dj
𫔎	jt	jj
𫘝	jt	mg
均	jp	ty
君	jp	ky
军	jp	bi
郡	jp	ej
菌	jp	ch
俊	jp	rj
峻	jp	uj
钧	jp	jy
骏	jp	mj
浚	jp	dj
畯	jp	tj
珺	jp	wj
麇	jp	lh
竣	jp	lj
焌	jp	hj
皲	jp	pj
晙	jp	oj
莙	jp	cj
葰	jp	cj
捃	jp	fj
筠	jp	vj
鲪	jp	yj
䐃	jp	oj
卡	ka	bx
咔	ka	kk
喀	ka	kk
胩	ka	ok
开	kl	ac
凯	kl	jj
铠	kl	jj
恺	kl	xj
揩	kl	fj
锎	kl	jk
闿	kl	mq
慨	kl	xj
锴	kl	jj
垲	kl	tj
忾	kl	xq
炌	kl	hj
剀	kl	dj
蒈	kl	cj
看	kj	ou
砍	kj	uq
坎	kj	tq
刊	kj	dg
堪	kj	tu
侃	kj	ri
勘	kj	lu
龛	kj	lh
阚	kj	mg
莰	kj	ck
瞰	kj	og
戡	kj	gu
衎	kj	xg
磡	kj	uk
崁	kj	uk
嵁	kj	uu
墈	kj	tk
抗	kh	fk
康	kh	gl
炕	kh	hk
糠	kh	mk
钪	kh	jk
慷	kh	xk
亢	kh	wj
伉	kh	rk
闶	kh	mk
𡐓	kh	tk
𩾌	kh	yk
靠	kk	fg
考	kk	lk
烤	kk	hk
拷	kk	fk
尻	kk	uj
铐	kk	jk
犒	kk	ng
栲	kk	mk
洘	kk	dk
㸆	kk	hk
可	ke	dk
课	ke	yg
克	ke	eg
科	ke	hd
客	ke	bg
氪	ke	qk
颗	ke	yg
壳	ke	uj
磕	ke	uh
刻	ke	dh
柯	ke	mk
嗑	ke	kh
珂	ke	wk
渴	ke	dh
棵	ke	mg
恪	ke	xg
颏	ke	yh
髁	ke	gg
苛	ke	ck
窠	ke	xg
轲	ke	ik
蝌	ke	ik
疴	ke	bk
瞌	ke	oh
坷	ke	tk
缂	ke	sg
锞	ke	jg
骒	ke	mg
炣	ke	hk
岢	ke	uk
稞	ke	hg
匼	ke	kh
溘	ke	dh
牁	ke	pk
剋	kz	dk
啃	kf	kk
肯	kf	ov
垦	kf	gt
恳	kf	gx
裉	kf	yg
坑	kg	tk
铿	kg	jj
硁	kg	ug
空	ks	xg
孔	ks	zg
控	ks	fk
恐	ks	xg
崆	ks	uk
硿	ks	uk
箜	ks	vk
倥	ks	rk
埪	ks	tk
口	kb	aa
扣	kb	fk
抠	kb	fq
寇	kb	bp
叩	kb	ke
蔻	kb	ck
芤	kb	ck
筘	kb	vk
眍	kb	oq
𫸩	kb	gq
库	ku	gi
哭	ku	kq
苦	ku	cg
酷	ku	yg
裤	ku	yk
枯	ku	mg
窟	ku	xq
喾	ku	dg
刳	ku	dk
骷	ku	gg
绔	ku	sk
矻	ku	uq
圐	ku	kf
跨	kw	zk
夸	kw	dk
垮	kw	tk
胯	kw	ok
挎	kw	fk
侉	kw	rk
姱	kw	nk
快	ky	xd
块	ky	td
筷	ky	vk
哙	ky	kh
脍	ky	oh
郐	ky	eh
侩	ky	rh
蒯	ky	dp
鲙	ky	yh
狯	ky	qh
㧟	ky	fh
款	kr	qu
宽	kr	bj
髋	kr	gk
狂	kd	qw
框	kd	mk
矿	kd	ug
筐	kd	vk
况	kd	dx
哐	kd	kk
旷	kd	og
眶	kd	ok
匡	kd	kw
诓	kd	yk
邝	kd	eg
诳	kd	yk
圹	kd	tg
贶	kd	bx
纩	kd	sg
夼	kd	di
洭	kd	dk
𫛭	kd	nk
亏	kv	ak
奎	kv	dg
窥	kv	xg
蝰	kv	ik
盔	kv	mh
夔	kv	wb
葵	kv	cg
魁	kv	gd
匮	kv	kg
愧	kv	xg
揆	kv	fg
馈	kv	ug
喹	kv	kk
逵	kv	zt
愦	kv	xg
傀	kv	rg
睽	kv	og
骙	kv	mg
櫆	kv	mk
馗	kv	ju
聩	kv	eg
跬	kv	zg
煃	kv	hk
悝	kv	xl
戣	kv	gg
喟	kv	kw
蒉	kv	cg
篑	kv	vg
岿	kv	ug
暌	kv	ot
𫠆	kv	yv
困	kp	km
坤	kp	tu
捆	kp	fk
昆	kp	ob
鲲	kp	yk
堃	kp	tf
髡	kp	iw
醌	kp	yk
琨	kp	wk
鹍	kp	nk
焜	kp	hk
阃	kp	mk
悃	kp	xk
锟	kp	jk
壸	kp	uy
裈	kp	yj
婫	kp	nk
扩	ko	fg
阔	ko	mh
括	ko	fu
廓	ko	gg
蛞	ko	iu
啦	la	kl
拉	la	fl
辣	la	xu
剌	la	du
蜡	la	ix
菈	la	cl
腊	la	ox
喇	la	kd
垃	la	tl
落	la	cl
邋	la	zl
镴	la	jl
旯	la	oj
蝲	la	id
揦	la	fd
瘌	la	bd
砬	la	ul
鞡	la	gl
𬶟	la	yl
来	ll	am
莱	ll	cl
赖	ll	uf
铼	ll	jl
濑	ll	dl
赉	ll	bl
徕	ll	xl
癞	ll	bl
睐	ll	ol
涞	ll	dl
崃	ll	ul
籁	ll	vl
俫	ll	rl
梾	ll	ml
烂	lj	hl
蓝	lj	cj
懒	lj	xl
兰	lj	bs
栏	lj	ml
揽	lj	fl
拦	lj	fl
篮	lj	vj
岚	lj	uf
滥	lj	dj
览	lj	jv
澜	lj	dl
榄	lj	ml
阑	lj	mj
镧	lj	jl
缆	lj	sl
婪	lj	nl
褴	lj	yj
斓	lj	wl
谰	lj	yl
罱	lj	sn
襕	lj	yj
漤	lj	dl
𬒗	lj	ul
狼	lh	ql
浪	lh	dl
郎	lh	el
朗	lh	ol
廊	lh	gl
啷	lh	kl
琅	lh	wl
烺	lh	hl
螂	lh	il
崀	lh	ul
阆	lh	ml
锒	lh	jl
榔	lh	ml
桹	lh	ml
埌	lh	tl
塱	lh	tl
莨	lh	cl
蒗	lh	cl
稂	lh	hl
筤	lh	vl
㫰	lh	ol
㮾	lh	ml
蓢	lh	cl
老	lk	bl
捞	lk	fl
佬	lk	rl
唠	lk	kl
劳	lk	cl
牢	lk	bn
烙	lk	hg
铑	lk	jl
姥	lk	nl
涝	lk	dl
醪	lk	yl
酪	lk	yg
痨	lk	bl
铹	lk	jl
嫪	lk	nl
崂	lk	ul
栳	lk	ml
荖	lk	cl
络	lk	sg
耢	lk	ll
𫭼	lk	tl
了	le	aa
乐	le	pd
勒	le	lg
叻	le	kl
仂	le	rl
鳓	le	yl
簕	le	vl
泐	le	dl
嘞	le	kl
类	lz	md
累	lz	st
雷	lz	yt
泪	lz	do
蕾	lz	cl
垒	lz	st
镭	lz	jl
肋	lz	ol
磊	lz	uu
擂	lz	fl
罍	lz	fl
酹	lz	yc
羸	lz	wf
诔	lz	yl
耒	lz	ad
藟	lz	cl
嫘	lz	nl
缧	lz	sl
儡	lz	rl
檑	lz	ml
礌	lz	ul
癗	lz	bl
冷	lg	dl
楞	lg	mf
愣	lg	xf
棱	lg	ml
崚	lg	ul
塄	lg	tf
堎	lg	tl
里	li	aa
离	li	wl
力	li	gp
李	li	mz
例	li	rl
利	li	hd
理	li	wl
立	li	da
礼	li	ug
粒	li	ml
梨	li	ml
锂	li	jl
历	li	il
丽	li	ad
哩	li	kl
黎	li	hu
栗	li	xm
璃	li	wl
莉	li	cl
吏	li	ad
戾	li	hq
鲤	li	yl
藜	li	cl
笠	li	vl
厘	li	il
犁	li	nl
厉	li	iw
狸	li	ql
隶	li	ad
栎	li	ml
骊	li	ml
俪	li	rl
荔	li	cl
澧	li	dd
沥	li	dl
励	li	ll
醴	li	yd
砾	li	ul
砺	li	ul
詈	li	sy
痢	li	bl
罹	li	sv
疠	li	bw
莅	li	cw
鳢	li	yd
俚	li	rl
篱	li	vl
郦	li	el
喱	li	kl
漓	li	dl
浬	li	dl
轹	li	il
俐	li	rl
蓠	li	cl
蛎	li	il
蠡	li	it
枥	li	ml
唳	li	kq
呖	li	kl
溧	li	dl
蜊	li	il
鲡	li	yl
醨	li	yl
嫠	li	nw
凓	li	dl
逦	li	zl
苈	li	cl
娌	li	nl
粝	li	ml
鹂	li	nl
黧	li	hd
缡	li	sl
傈	li	rl
坜	li	tl
疬	li	bl
跞	li	zl
朸	li	ml
珕	li	wl
浰	li	dl
雳	li	yl
猁	li	ql
篥	li	vl
㰀	li	ml
𫵷	li	ul
𬍛	li	wl
俩	lw	rl
连	lm	zi
练	lm	sd
脸	lm	oa
链	lm	jl
联	lm	eg
恋	lm	xy
莲	lm	cl
帘	lm	bj
炼	lm	hd
镰	lm	jl
敛	lm	wa
怜	lm	xl
廉	lm	gj
濂	lm	dl
涟	lm	dl
殓	lm	da
蠊	lm	il
琏	lm	wl
鲢	lm	yl
楝	lm	mj
奁	lm	dq
蔹	lm	cl
梿	lm	ml
裢	lm	yl
潋	lm	dl
裣	lm	ya
瑓	lm	wj
𬶠	lm	yj
量	ld	ol
两	ld	ad
亮	ld	wj
梁	ld	mb
辆	ld	il
凉	ld	dj
粮	ld	ml
良	ld	dg
晾	ld	oj
谅	ld	yj
粱	ld	mb
椋	ld	mj
俍	ld	rl
魉	ld	gl
墚	ld	tl
踉	ld	zl
辌	ld	ij
悢	ld	xl
𫟅	ld	sj
𬜯	ld	cl
聊	lc	em
撩	lc	fl
料	lc	md
辽	lc	zl
廖	lc	gl
寮	lc	bl
撂	lc	fg
疗	lc	bl
蓼	lc	cl
瞭	lc	ol
钌	lc	jl
燎	lc	hl
獠	lc	ql
潦	lc	dl
僚	lc	rl
憭	lc	xl
髎	lc	gl
寥	lc	bl
嘹	lc	kl
橑	lc	ml
嫽	lc	nl
缭	lc	sl
镣	lc	jl
尥	lc	yu
蹽	lc	zl
漻	lc	dl
鹩	lc	nl
簝	lc	vl
𪤗	lc	tl
列	lx	dd
咧	lx	kl
猎	lx	qx
烈	lx	dl
裂	lx	yl
劣	lx	lu
鬣	lx	il
洌	lx	dl
捩	lx	fl
冽	lx	dl
埒	lx	tc
躐	lx	zl
趔	lx	zl
峛	lx	ul
脟	lx	oc
䴕	lx	nl
𫚭	lx	yl
林	ln	mm
拎	ln	fl
临	ln	ao
磷	ln	ul
凛	ln	db
淋	ln	dl
琳	ln	wl
鳞	ln	yl
邻	ln	el
麟	ln	ll
璘	ln	wl
啉	ln	kl
霖	ln	yl
廪	ln	gb
赁	ln	br
膦	ln	ol
蔺	ln	cv
吝	ln	kw
檩	ln	mb
懔	ln	xb
潾	ln	dl
粼	ln	md
嶙	ln	ul
躏	ln	zl
遴	ln	zl
辚	ln	il
箖	ln	vl
瞵	ln	ol
翷	ln	yl
𬭸	ln	jl
𬴊	ln	ml
令	ly	rs
另	ly	kl
零	ly	yl
领	ly	yl
铃	ly	jl
灵	ly	hx
玲	ly	wl
岭	ly	ul
陵	ly	el
凌	ly	dl
绫	ly	sl
龄	ly	il
翎	ly	yl
泠	ly	dl
聆	ly	el
澪	ly	dl
伶	ly	rl
菱	ly	cl
蛉	ly	il
苓	ly	cl
姈	ly	nl
呤	ly	kl
羚	ly	yl
瓴	ly	wl
棂	ly	ml
祾	ly	ul
鲮	ly	yl
舲	ly	vl
酃	ly	ek
坽	ly	tl
囹	ly	kl
柃	ly	ml
〇	ly	aa
鸰	ly	nl
昤	ly	ol
㥄	ly	xl
六	lq	wb
留	lq	td
流	lq	di
刘	lq	dw
溜	lq	dl
柳	lq	mm
硫	lq	ui
瘤	lq	bl
遛	lq	zl
镠	lq	jl
琉	lq	wi
熘	lq	hl
浏	lq	dl
绺	lq	sj
榴	lq	ml
旒	lq	fi
陆	lq	ej
鎏	lq	jl
骝	lq	ml
馏	lq	ul
镏	lq	jl
锍	lq	ji
珋	lq	wm
疁	lq	tl
罶	lq	sl
鹨	lq	nl
瑬	lq	yl
飗	lq	fl
碌	lq	ul
鹠	lq	nl
龙	ls	ad
隆	ls	eu
笼	ls	vl
泷	ls	dl
拢	ls	fl
陇	ls	el
聋	ls	el
胧	ls	ol
珑	ls	wl
垄	ls	lt
栊	ls	ml
茏	ls	cl
砻	ls	lu
咙	ls	kl
哢	ls	kn
癃	ls	bl
窿	ls	xl
昽	ls	ol
弄	ls	cw
漋	ls	dl
眬	ls	ol
𬕂	ls	vg
楼	lb	ml
喽	lb	kl
漏	lb	dl
搂	lb	fl
娄	lb	mn
瘘	lb	bl
露	lb	yl
镂	lb	jl
篓	lb	vl
陋	lb	ea
蒌	lb	cl
耧	lb	ll
蝼	lb	il
偻	lb	rl
溇	lb	dl
髅	lb	gl
嵝	lb	ul
䁖	lb	ol
剅	lb	dd
𦝼	lb	ol
𪣻	lb	tl
路	lu	zg
录	lu	au
撸	lu	fl
鲁	lu	yo
鹿	lu	gb
卢	lu	bu
卤	lu	ba
炉	lu	hh
虏	lu	hl
噜	lu	kl
麓	lu	ll
掳	lu	fl
戮	lu	gl
禄	lu	ul
庐	lu	gh
橹	lu	ml
垆	lu	tl
颅	lu	yl
芦	lu	ch
璐	lu	wl
鹭	lu	nl
泸	lu	dl
潞	lu	dl
胪	lu	ol
渌	lu	dl
镥	lu	jl
赂	lu	bg
鲈	lu	yl
菉	lu	cl
簏	lu	vl
蕗	lu	cl
漉	lu	dl
辂	lu	ig
僇	lu	rl
箓	lu	vl
栌	lu	ml
舻	lu	vl
琭	lu	wl
辘	lu	il
逯	lu	zl
鸬	lu	nl
甪	lu	py
绿	lu	sl
轳	lu	il
勠	lu	ll
澛	lu	dl
氇	lu	ml
稑	lu	ht
𫘧	lu	ml
𬬻	lu	jl
乱	lr	ug
卵	lr	pd
鸾	lr	ny
栾	lr	my
銮	lr	jy
娈	lr	ny
挛	lr	uy
峦	lr	uy
脔	lr	ry
孪	lr	yz
滦	lr	dl
论	lp	yl
轮	lp	il
抡	lp	fl
伦	lp	rl
仑	lp	rb
沦	lp	dl
囵	lp	kl
𫭢	lp	tl
𬬭	lp	jl
罗	lo	sx
洛	lo	dg
裸	lo	yg
啰	lo	kl
摞	lo	fl
骆	lo	mg
螺	lo	il
骡	lo	ml
萝	lo	cl
锣	lo	jl
雒	lo	vg
珞	lo	wg
逻	lo	zl
蠃	lo	dd
箩	lo	vl
泺	lo	dl
荦	lo	cn
漯	lo	dl
捋	lo	fc
倮	lo	rg
椤	lo	ml
瘰	lo	bl
猡	lo	ql
蓏	lo	cg
脶	lo	og
率	lv	wu
铝	lv	jl
吕	lv	kk
驴	lv	mh
律	lv	xy
旅	lv	fp
氯	lv	ql
屡	lv	ul
滤	lv	dl
虑	lv	hx
履	lv	uf
缕	lv	sl
侣	lv	rl
闾	lv	ml
膂	lv	ol
梠	lv	ml
榈	lv	ml
褛	lv	yl
稆	lv	hl
葎	lv	cl
垏	lv	ty
略	lt	tg
掠	lt	fj
锊	lt	jc
圙	lt	km
䂮	lt	uq
吗	ma	km
嘛	ma	km
骂	ma	km
马	ma	aa
码	ma	um
妈	ma	nm
麻	ma	gl
玛	ma	wm
蚂	ma	im
抹	ma	fm
蟆	ma	im
祃	ma	um
犸	ma	qm
摩	ma	mu
杩	ma	mm
买	ml	at
卖	ml	um
麦	ml	fw
埋	ml	tl
迈	ml	zw
脉	ml	oy
霾	ml	yl
唛	ml	km
劢	ml	lw
荬	ml	cm
鿏	ml	jm
慢	mj	xm
满	mj	dl
蛮	mj	iy
曼	mj	oy
漫	mj	dm
螨	mj	il
瞒	mj	ol
蔓	mj	cm
幔	mj	jm
鳗	mj	ym
缦	mj	sm
馒	mj	um
谩	mj	ym
鬘	mj	im
墁	mj	tm
嫚	mj	nm
镘	mj	jm
颟	mj	yl
鞔	mj	gm
𬜬	mj	cw
忙	mh	xw
盲	mh	ow
莽	mh	cc
芒	mh	cw
氓	mh	wm
蟒	mh	im
茫	mh	cw
邙	mh	ew
漭	mh	dm
尨	mh	ap
杧	mh	mw
牻	mh	nl
牤	mh	nw
厖	mh	il
硭	mh	um
猫	mk	qm
毛	mk	pg
冒	mk	oo
帽	mk	jm
锚	mk	jm
贸	mk	bd
矛	mk	sp
茅	mk	cm
卯	mk	ep
貌	mk	ve
昴	mk	om
茂	mk	cw
冇	mk	uk
旄	mk	fm
峁	mk	um
髦	mk	im
铆	mk	jm
耄	mk	lm
楙	mk	mm
懋	mk	xm
芼	mk	cm
瑁	mk	wm
牦	mk	nm
茆	mk	cm
袤	mk	ym
瞀	mk	om
泖	mk	dm
蝥	mk	im
眊	mk	om
鄚	mk	em
蟊	mk	im
么	me	ps
没	mz	du
每	mz	pm
美	mz	dy
枚	mz	mw
梅	mz	mm
酶	mz	ym
妹	mz	nw
镁	mz	jm
煤	mz	hm
霉	mz	ym
眉	mz	om
魅	mz	gw
玫	mz	ww
媚	mz	nm
媒	mz	nm
昧	mz	ow
莓	mz	cm
郿	mz	em
镅	mz	jm
寐	mz	bw
湄	mz	dm
浼	mz	dm
袂	mz	yd
楣	mz	mm
鹛	mz	nm
渼	mz	dm
瑂	mz	wm
糜	mz	mm
媄	mz	nm
嵋	mz	um
们	mf	rm
门	mf	dg
焖	mf	hm
闷	mf	mx
扪	mf	fm
钔	mf	jm
呇	mf	uk
懑	mf	xm
𫞩	mf	wl
梦	mg	mx
猛	mg	qm
萌	mg	cm
蒙	mg	cm
懵	mg	xm
孟	mg	mz
锰	mg	jm
盟	mg	mm
濛	mg	dm
獴	mg	qm
勐	mg	lm
虻	mg	iw
檬	mg	mm
蠓	mg	im
甍	mg	cw
艋	mg	vm
朦	mg	om
瞢	mg	co
幪	mg	jm
艨	mg	vm
蜢	mg	im
礞	mg	um
㠓	mg	um
鹲	mg	nm
𫑡	mg	em
米	mi	dd
迷	mi	zm
密	mi	ub
谜	mi	ym
蜜	mi	ib
咪	mi	km
弥	mi	ge
觅	mi	jv
幂	mi	bj
蘼	mi	cf
芈	mi	aa
靡	mi	fm
醚	mi	ym
眯	mi	om
祕	mi	ub
祢	mi	ue
弭	mi	ge
麋	mi	lm
汨	mi	do
蓂	mi	cl
脒	mi	om
谧	mi	ym
醾	mi	ym
縻	mi	ms
猕	mi	qm
敉	mi	mw
洣	mi	dm
嘧	mi	km
面	mm	aa
免	mm	de
棉	mm	mb
眠	mm	om
缅	mm	sm
绵	mm	sb
勉	mm	lm
冕	mm	om
沔	mm	dg
眄	mm	og
丏	mm	ag
勔	mm	lm
愐	mm	xm
娩	mm	nm
湎	mm	dm
腼	mm	om
偭	mm	rm
渑	mm	dd
𩾃	mm	ym
秒	mc	hu
喵	mc	km
瞄	mc	om
庙	mc	gy
妙	mc	nu
苗	mc	ct
描	mc	fm
淼	mc	uu
渺	mc	dm
眇	mc	ou
缈	mc	sm
杪	mc	mu
邈	mc	ze
藐	mc	ce
缪	mc	sl
鹋	mc	nm
灭	mx	ah
咩	mx	ky
乜	mx	gg
蔑	mx	cu
篾	mx	vu
民	mn	ag
敏	mn	wm
抿	mn	fm
皿	mn	aa
闽	mn	im
泯	mn	dm
闵	mn	mw
旻	mn	ow
缗	mn	so
愍	mn	xw
岷	mn	um
湣	mn	dh
珉	mn	wm
悯	mn	xm
鳘	mn	ym
黾	mn	kd
忞	mn	wx
苠	mn	cm
名	my	xk
命	my	re
明	my	oo
鸣	my	kn
茗	my	cm
冥	my	bl
铭	my	jm
暝	my	ol
洺	my	dm
溟	my	dl
瞑	my	ol
螟	my	il
酩	my	ym
谬	mq	yl
莫	mo	cd
魔	mo	gm
膜	mo	om
磨	mo	mu
摸	mo	fm
末	mo	ad
麽	mo	mm
墨	mo	th
默	mo	hq
模	mo	mm
馍	mo	um
沫	mo	dm
摹	mo	cu
殁	mo	du
陌	mo	eb
茉	mo	cm
谟	mo	ym
貘	mo	vm
漠	mo	dm
貊	mo	vb
镆	mo	jm
蘑	mo	cm
蓦	mo	cm
秣	mo	hm
寞	mo	bm
万	mo	ag
瘼	mo	bm
嬷	mo	nm
耱	mo	lm
无	mo	ag
嫫	mo	nm
靺	mo	gm
藦	mo	cm
𬙊	mo	sm
某	mb	gm
谋	mb	ym
牟	mb	sn
眸	mb	om
哞	mb	km
侔	mb	rm
鍪	mb	jm
蛑	mb	im
木	mu	ad
目	mu	aa
姆	mu	nm
墓	mu	tm
母	mu	ad
穆	mu	hp
沐	mu	dm
亩	mu	wt
牧	mu	nw
暮	mu	om
慕	mu	cx
幕	mu	jm
钼	mu	jo
募	mu	lm
牡	mu	nt
拇	mu	fm
睦	mu	ot
呒	mu	kw
苜	mu	co
仫	mu	rm
毪	mu	mm
𧿹	mu	zm
𬭁	mu	jm
那	na	el
拿	na	uh
哪	na	kn
呐	na	kn
娜	na	nn
纳	na	sn
钠	na	jn
捺	na	fn
镎	na	jn
衲	na	yn
乸	na	ym
南	na	ua
肭	na	on
𦰡	na	cn
乃	nl	pg
奶	nl	nn
耐	nl	ce
奈	nl	du
氖	nl	qn
萘	nl	cn
柰	nl	mu
迺	nl	zx
艿	nl	cn
鼐	nl	nd
佴	nl	re
难	nj	yv
男	nj	tl
楠	nj	mn
喃	nj	kn
腩	nj	on
囡	nj	kn
赧	nj	iy
蝻	nj	in
婻	nj	nn
萳	nj	cn
囊	nh	ay
馕	nh	un
曩	nh	ox
攮	nh	fn
齉	nh	bn
囔	nh	kn
脑	nk	ox
闹	nk	mu
挠	nk	fy
恼	nk	xx
瑙	nk	wi
淖	nk	dv
孬	nk	bh
铙	nk	jy
垴	nk	tx
呶	nk	kn
猱	nk	qr
臑	nk	ox
蛲	nk	iy
硇	nk	ui
峱	nk	qu
呢	ne	kn
讷	ne	yn
内	nz	ad
馁	nz	ut
嫩	nf	ni
恁	nf	xr
能	ng	sb
你	ni	re
尼	ni	ub
逆	ni	zn
拟	ni	fy
泥	ni	dn
匿	ni	kr
腻	ni	oe
妮	ni	nn
倪	ni	re
溺	ni	dr
铌	ni	jn
昵	ni	on
霓	ni	ye
睨	ni	oe
伲	ni	rn
鲵	ni	ye
猊	ni	qe
旎	ni	fn
麑	ni	le
坭	ni	tn
怩	ni	xn
薿	ni	cy
𨺙	ni	ee
𫐐	ni	ie
𫠜	ni	ie
年	nm	pa
念	nm	xj
黏	nm	hv
碾	nm	uv
撵	nm	fi
捻	nm	fn
辇	nm	if
蔫	nm	cy
鲶	nm	yn
拈	nm	fv
廿	nm	aa
鲇	nm	yv
埝	nm	tn
粘	nm	mv
娘	nd	nl
酿	nd	yl
嬢	nd	ny
鸟	nc	na
尿	nc	uu
茑	nc	cn
脲	nc	on
袅	nc	yn
捏	nx	fn
镍	nx	jm
涅	nx	dn
孽	nx	cz
聂	nx	eu
镊	nx	jn
颞	nx	yn
蹑	nx	zn
臬	nx	zm
啮	nx	ki
蘖	nx	cm
嗫	nx	kn
嵲	nx	un
菍	nx	cn
糵	nx	cm
陧	nx	en
𫔶	nx	mm
您	nn	xn
拧	ny	fn
宁	ny	bd
凝	ny	dy
甯	ny	by
狞	ny	qn
柠	ny	mn
苧	ny	cn
佞	ny	rn
泞	ny	dn
咛	ny	kn
聍	ny	en
牛	nq	pa
扭	nq	fi
妞	nq	ni
纽	nq	si
钮	nq	ji
狃	nq	qi
忸	nq	xi
浓	ns	dn
农	ns	by
侬	ns	rn
脓	ns	on
秾	ns	hn
哝	ns	kn
𬪩	ns	yn
耨	nb	lr
怒	nu	xn
努	nu	ln
弩	nu	gn
奴	nu	ny
驽	nu	mn
傉	nu	rr
孥	nu	zn
砮	nu	un
胬	nu	rn
笯	nu	vn
暖	nr	oy
诺	no	yr
挪	no	fn
糯	no	mx
喏	no	kr
傩	no	rn
懦	no	xx
搦	no	fr
锘	no	jr
女	nv	aa
钕	nv	jn
衄	nv	xi
恧	nv	xe
虐	nt	ha
疟	nt	ba
噢	oo	ka
喔	oo	kw
欧	ou	qq
藕	ou	co
偶	ou	ry
呕	ou	kq
鸥	ou	nq
区	ou	ki
沤	ou	dq
殴	ou	uq
耦	ou	ly
讴	ou	yq
瓯	ou	wq
怄	ou	xq
𠙶	ou	kl
𬉼	ou	hq
怕	pa	xb
爬	pa	vb
趴	pa	zb
啪	pa	kp
帕	pa	jb
琶	pa	bw
葩	pa	cb
杷	pa	mb
舥	pa	vb
潖	pa	db
筢	pa	vb
拍	pl	fb
派	pl	dp
牌	pl	pb
排	pl	ff
哌	pl	kp
湃	pl	db
俳	pl	rf
蒎	pl	cp
徘	pl	xf
迫	pl	zb
簰	pl	vp
盘	pj	mv
判	pj	db
潘	pj	df
畔	pj	tb
攀	pj	ud
盼	pj	of
叛	pj	fb
爿	pj	aa
磐	pj	ub
泮	pj	db
槃	pj	mb
袢	pj	yb
蟠	pj	if
襻	pj	yp
胖	pj	ob
磻	pj	uf
蹒	pj	zl
旁	ph	wf
庞	ph	gl
滂	ph	dp
彷	ph	xf
乓	ph	qd
雱	ph	yf
逄	ph	zf
螃	ph	ip
耪	ph	lp
鳑	ph	yp
跑	pk	zb
泡	pk	db
抛	pk	fl
袍	pk	yb
匏	pk	bk
庖	pk	gb
咆	pk	kb
狍	pk	qb
疱	pk	bb
脬	pk	of
配	pz	yj
赔	pz	bk
陪	pz	ek
佩	pz	rb
呸	pz	kp
胚	pz	op
裴	pz	yf
培	pz	tk
醅	pz	yk
珮	pz	wb
沛	pz	df
辔	pz	ik
旆	pz	ff
锫	pz	jk
帔	pz	jp
霈	pz	yp
衃	pz	xb
喷	pf	kb
盆	pf	mf
湓	pf	dp
捧	pg	ff
碰	pg	ub
彭	pg	pd
砰	pg	up
棚	pg	mp
硼	pg	up
朋	pg	oo
鹏	pg	np
烹	pg	hh
嘭	pg	kp
蓬	pg	cf
膨	pg	op
篷	pg	vf
澎	pg	dp
芃	pg	cf
蟛	pg	ip
抨	pg	fp
椪	pg	mb
怦	pg	xp
弸	pg	gp
堋	pg	tp
淜	pg	dp
皮	pi	ad
批	pi	fb
屁	pi	ub
劈	pi	db
匹	pi	ke
啤	pi	kb
脾	pi	ob
癖	pi	bb
披	pi	fp
铍	pi	jp
丕	pi	ab
疲	pi	bp
毗	pi	tb
痞	pi	bf
坯	pi	tp
嚭	pi	xf
罴	pi	db
僻	pi	rb
譬	pi	yb
噼	pi	kb
琵	pi	wb
蜱	pi	ib
貔	pi	vb
圮	pi	tj
邳	pi	ep
郫	pi	eb
伾	pi	rp
霹	pi	yb
媲	pi	nb
澼	pi	db
鼙	pi	gb
陴	pi	eb
甓	pi	wb
睥	pi	ob
埤	pi	tb
淠	pi	db
狉	pi	qp
枇	pi	mb
砒	pi	ub
蚍	pi	ib
纰	pi	sb
仳	pi	rb
鲏	pi	yp
䴙	pi	nb
苉	pi	cp
𬳵	pi	mp
篇	pm	vb
偏	pm	rb
片	pm	pa
骗	pm	mb
骈	pm	mb
谝	pm	yb
翩	pm	yb
楩	pm	mb
胼	pm	ob
蹁	pm	zb
犏	pm	nb
㛹	pm	nb
𡎚	pm	tb
票	pc	xu
飘	pc	fp
漂	pc	dp
嫖	pc	np
瞟	pc	op
瓢	pc	gp
剽	pc	dp
缥	pc	sp
朴	pc	mb
殍	pc	df
薸	pc	cp
嘌	pc	kp
蔈	pc	cp
螵	pc	ip
撇	px	fb
瞥	px	ob
氕	px	qp
苤	px	cp
𬭯	px	jb
拼	pn	fb
品	pn	kk
频	pn	yb
贫	pn	bf
聘	pn	ek
嫔	pn	nb
牝	pn	nb
颦	pn	bp
姘	pn	nb
玭	pn	wb
𬞟	pn	cp
平	py	aa
凭	py	jr
瓶	py	wb
评	py	yp
坪	py	tp
萍	py	cp
枰	py	mp
乒	py	jp
苹	py	cp
娉	py	np
洴	py	db
鲆	py	yp
俜	py	rk
泙	py	dp
玶	py	wp
涄	py	dk
帡	py	jb
荓	py	cb
蚲	py	ip
破	po	up
坡	po	tp
颇	po	yp
泼	po	df
婆	po	nb
珀	po	wb
魄	po	bg
钋	po	jb
钷	po	jk
粕	po	mb
鄱	po	ef
皤	po	bf
叵	po	kk
酦	po	yf
桲	po	mb
笸	po	vk
䥽	po	jf
剖	pb	dk
裒	pb	wy
掊	pb	fk
抔	pb	fb
谱	pu	yp
铺	pu	jf
扑	pu	fb
普	pu	ob
噗	pu	kd
葡	pu	cp
璞	pu	wd
蒲	pu	cp
仆	pu	rb
浦	pu	df
濮	pu	df
莆	pu	cf
溥	pu	dc
圃	pu	kf
蹼	pu	zd
镤	pu	jd
镨	pu	jp
菩	pu	ck
酺	pu	yf
匍	pu	gf
蒱	pu	cb
潽	pu	dp
墣	pu	td
氆	pu	mp
穙	pu	hd
其	qi	ba
起	qi	zj
七	qi	ag
气	qi	py
器	qi	kk
骑	qi	mq
齐	qi	wa
棋	qi	mq
漆	qi	dq
弃	qi	cw
旗	qi	fq
妻	qi	na
绮	qi	sq
欺	qi	qq
岂	qi	uj
砌	qi	uq
琪	qi	wq
启	qi	hk
企	qi	rv
契	qi	dd
淇	qi	dq
泣	qi	dl
鳍	qi	yo
琦	qi	wq
栖	qi	mx
乞	qi	py
祁	qi	eu
戚	qi	gx
祇	qi	uu
麒	qi	lq
炁	qi	hg
汽	qi	dq
柒	qi	mq
脐	qi	oq
沏	qi	dq
祈	qi	uj
祺	qi	uq
讫	qi	yq
蕲	qi	cj
崎	qi	uq
岐	qi	uv
迄	qi	zq
杞	qi	mj
萁	qi	cq
嘁	qi	kq
欹	qi	qq
槭	qi	mq
锜	qi	jq
凄	qi	dq
碛	qi	uz
畦	qi	tg
歧	qi	vv
綦	qi	qs
玘	qi	wj
芪	qi	cu
亓	qi	aq
耆	qi	lo
芑	qi	cj
屺	qi	uj
跂	qi	zv
埼	qi	tq
憩	qi	xz
蜞	qi	iq
棨	qi	mw
葺	qi	ce
汔	qi	dq
蹊	qi	zx
颀	qi	jy
骐	qi	mq
圻	qi	tj
磜	qi	uj
萋	qi	cq
蛴	qi	iq
愭	qi	xo
桤	qi	mj
俟	qi	ru
郪	qi	eq
婍	qi	nq
洓	qi	dc
鲯	qi	yq
碶	qi	uq
䓫	qi	cq
𨙸	qi	ve
𬨂	qi	iu
掐	qw	fj
恰	qw	xh
髂	qw	gk
洽	qw	dh
袷	qw	yh
拤	qw	fk
葜	qw	cq
前	qm	bd
钱	qm	jj
签	qm	va
千	qm	pa
浅	qm	dj
欠	qm	dr
铅	qm	jk
牵	qm	nb
遣	qm	zg
潜	qm	dt
迁	qm	zq
钳	qm	jg
乾	qm	qu
谦	qm	yj
嵌	qm	uq
黔	qm	hj
茜	qm	cx
钤	qm	jj
芡	qm	cq
歉	qm	qj
虔	qm	hw
芊	qm	cq
倩	qm	rq
骞	qm	bm
仟	qm	rq
堑	qm	tv
搴	qm	bu
阡	qm	eq
汧	qm	dk
谴	qm	yq
褰	qm	by
靬	qm	gg
荨	qm	cx
愆	qm	xy
佥	qm	ra
椠	qm	mv
扦	qm	fq
缱	qm	sq
慊	qm	xj
悭	qm	xj
钎	qm	jq
杄	qm	mq
鹐	qm	nj
蒨	qm	cq
岍	qm	uk
磏	qm	uj
纤	qm	sq
掮	qm	fj
墘	qm	tq
肷	qm	oq
圲	qm	tq
伣	qm	rj
𬘬	qm	sq
抢	qd	fc
枪	qd	mc
墙	qd	th
腔	qd	ok
呛	qd	kc
羌	qd	yg
羟	qd	yg
蔷	qd	ch
炝	qd	hc
锵	qd	jj
戗	qd	gc
戕	qd	gp
锖	qd	jq
樯	qd	mh
玱	qd	wc
镪	qd	jq
蜣	qd	ig
嫱	qd	nh
襁	qd	yq
跄	qd	zc
蔃	qd	cq
敲	qc	gy
桥	qc	mq
乔	qc	pp
翘	qc	gy
瞧	qc	oj
巧	qc	gk
撬	qc	fm
鞘	qc	gx
樵	qc	mj
俏	qc	rx
跷	qc	zy
窍	qc	xq
谯	qc	yj
锹	qc	jq
侨	qc	rq
悄	qc	xx
荞	qc	cq
诮	qc	yx
橇	qc	mm
劁	qc	dj
峭	qc	ux
缲	qc	sz
硚	qc	uq
鞒	qc	gq
雀	qc	vx
憔	qc	xj
愀	qc	xq
硗	qc	uy
且	qx	aa
切	qx	dq
妾	qx	nl
窃	qx	xq
怯	qx	xq
箧	qx	vj
挈	qx	ud
锲	qx	jq
惬	qx	xj
郄	qx	eh
琴	qn	wj
秦	qn	hf
亲	qn	lm
勤	qn	lj
寝	qn	by
擒	qn	fq
钦	qn	jq
沁	qn	dx
侵	qn	ry
禽	qn	rl
衾	qn	yj
噙	qn	kq
芹	qn	cj
溱	qn	dq
骎	qn	my
嗪	qn	kq
芩	qn	cj
覃	qn	xz
揿	qn	fq
慬	qn	xj
嵚	qn	uq
螓	qn	iq
锓	qn	jy
檎	qn	mq
吣	qn	kx
请	qy	yq
轻	qy	ig
清	qy	dq
情	qy	xq
氢	qy	qg
青	qy	of
晴	qy	oq
卿	qy	mg
倾	qy	rq
庆	qy	gd
氰	qy	qq
黥	qy	hj
顷	qy	by
磬	qy	uq
擎	qy	uj
鲭	qy	yq
箐	qy	vq
罄	qy	fq
蜻	qy	iq
綮	qy	sw
檠	qy	mj
圊	qy	kq
勍	qy	lj
碃	qy	uq
庼	qy	gq
苘	qy	ct
穷	qs	xl
琼	qs	wj
邛	qs	eg
蛩	qs	ig
穹	qs	xg
茕	qs	cu
銎	qs	jg
筇	qs	ve
䓖	qs	cq
球	qq	wq
求	qq	ad
秋	qq	hh
邱	qq	eq
丘	qq	pa
裘	qq	yq
糗	qq	mi
楸	qq	mq
囚	qq	kr
逑	qq	zq
虬	qq	ig
璆	qq	wl
酋	qq	by
萩	qq	cq
遒	qq	zq
鳅	qq	yq
泅	qq	dq
俅	qq	rq
鼽	qq	bj
赇	qq	bq
蚯	qq	iq
蝤	qq	iq
鹙	qq	nq
訄	qq	jy
犰	qq	qj
巯	qq	ai
鞧	qq	gq
𨱇	qq	jq
去	qu	ts
取	qu	ey
曲	qu	aa
娶	qu	nq
屈	qu	ui
趣	qu	zq
蛆	qu	iq
祛	qu	uq
龋	qu	iy
驱	qu	mq
瞿	qu	vo
渠	qu	mj
趋	qu	zi
躯	qu	uq
鼩	qu	uj
觑	qu	jx
诎	qu	yi
麹	qu	mj
衢	qu	ri
朐	qu	oj
蕖	qu	cq
蘧	qu	cj
袪	qu	yq
胠	qu	oq
劬	qu	lj
阒	qu	mj
癯	qu	bq
璩	qu	wj
鸲	qu	nj
戌	qu	ga
蠼	qu	ij
氍	qu	mq
黢	qu	hj
坥	qu	tq
灈	qu	dq
岖	qu	uq
蛐	qu	iq
磲	qu	uq
竘	qu	lj
㭕	qu	mq
䓛	qu	cq
𪨰	qu	uq
𫭟	qu	tq
全	qr	rw
权	qr	my
劝	qr	ly
券	qr	df
拳	qr	uf
犬	qr	dd
泉	qr	bu
醛	qr	yq
蜷	qr	ij
荃	qr	cq
颧	qr	yv
诠	qr	yq
佺	qr	rq
铨	qr	jq
鬈	qr	ij
痊	qr	bq
绻	qr	sj
筌	qr	vq
畎	qr	tq
悛	qr	xj
辁	qr	iq
棬	qr	mj
瑔	qr	wq
鳈	qr	yq
婘	qr	nj
𨟠	qr	eq
却	qt	eq
缺	qt	fd
确	qt	uj
卻	qt	eg
阙	qt	mj
瘸	qt	br
鹊	qt	nx
榷	qt	mv
炔	qt	hd
阕	qt	mg
悫	qt	xk
碏	qt	ux
埆	qt	tj
𬒈	qt	ub
群	qp	yj
裙	qp	yj
囷	qp	kh
逡	qp	zw
然	rj	hq
燃	rj	hr
染	rj	mg
冉	rj	aa
髯	rj	ir
蚺	rj	ir
苒	rj	cr
䎃	rj	yr
让	rh	yu
穰	rh	hx
嚷	rh	kx
瓤	rh	gx
攘	rh	fx
壤	rh	tx
瀼	rh	dx
禳	rh	ux
儴	rh	rx
蘘	rh	cx
绕	rk	sy
饶	rk	uy
扰	rk	fy
桡	rk	my
娆	rk	ny
荛	rk	cy
热	re	dv
惹	re	cx
人	rf	pd
任	rf	rr
认	rf	yr
忍	rf	xr
仁	rf	re
刃	rf	dd
壬	rf	pu
韧	rf	wr
饪	rf	ur
稔	rf	hn
妊	rf	nr
衽	rf	yr
纫	rf	sr
仞	rf	rr
轫	rf	ir
讱	rf	yr
纴	rf	sr
荏	rf	cr
葚	rf	cu
仍	rg	rn
扔	rg	fn
日	ri	aa
驲	ri	mo
融	rs	ig
容	rs	bg
蓉	rs	cr
荣	rs	cm
溶	rs	dr
戎	rs	gu
熔	rs	hr
绒	rs	sr
茸	rs	ce
冗	rs	bj
榕	rs	mr
镕	rs	jr
狨	rs	qr
嵘	rs	ur
瑢	rs	wr
蝾	rs	ir
肉	rb	ad
揉	rb	fr
柔	rb	mm
鞣	rb	gr
糅	rb	mr
蹂	rb	zr
𫐓	rb	ir
如	ru	nk
入	ru	pd
乳	ru	fg
汝	ru	dn
儒	ru	rx
辱	ru	ci
濡	ru	dx
茹	ru	cr
铷	ru	jr
襦	ru	yx
褥	ru	yr
蓐	ru	cr
孺	ru	zx
洳	ru	dr
蠕	ru	ix
溽	ru	dr
缛	ru	sr
嬬	ru	nx
嚅	ru	kx
薷	ru	cx
颥	ru	yx
挼	rw	ft
软	rr	iq
阮	rr	ey
堧	rr	td
瓀	rr	wx
媆	rr	nd
瑞	rv	we
睿	rv	bo
锐	rv	jd
蕊	rv	cr
芮	rv	cn
汭	rv	dn
蚋	rv	in
蕤	rv	cr
枘	rv	mn
润	rp	dr
闰	rp	mw
若	ro	cy
弱	ro	gd
箬	ro	vr
鄀	ro	er
偌	ro	rr
爇	ro	cr
蒻	ro	cr
婼	ro	nr
撒	sa	fs
仨	sa	rs
萨	sa	ci
洒	sa	dx
飒	sa	fl
卅	sa	aa
靸	sa	gj
潵	sa	ds
挲	sa	uu
脎	sa	ou
赛	sl	bb
塞	sl	tb
鳃	sl	ys
腮	sl	os
噻	sl	ks
三	sj	aa
散	sj	wo
伞	sj	ru
叁	sj	ss
糁	sj	mc
毵	sj	mc
馓	sj	us
丧	sh	ty
桑	sh	mr
嗓	sh	ks
颡	sh	ys
搡	sh	fs
磉	sh	us
扫	sk	fx
骚	sk	mi
嫂	sk	ns
搔	sk	fi
臊	sk	oz
埽	sk	tj
缫	sk	sg
瘙	sk	bi
溞	sk	dz
色	se	db
瑟	se	wb
涩	se	dv
铯	se	js
啬	se	th
穑	se	hh
璱	se	ws
森	sf	ml
僧	sg	rc
啥	ua	ku
杀	ua	mi
傻	ua	rw
沙	ua	du
鲨	ua	yu
莎	ua	cu
煞	ua	hw
纱	ua	su
砂	ua	uu
痧	ua	bu
厦	ua	ix
嗄	ua	kx
歃	ua	qi
唼	ua	kq
霎	ua	yq
铩	ua	ju
裟	ua	yu
杉	ua	mp
晒	ul	ox
筛	ul	vu
山	uj	aa
删	uj	dc
闪	uj	mr
善	uj	yk
扇	uj	hy
衫	uj	yp
擅	uj	fd
珊	uj	wc
陕	uj	ej
膳	uj	ou
疝	uj	bu
煽	uj	hu
骟	uj	mu
赡	uj	bv
钐	uj	jp
讪	uj	yu
剡	uj	dy
缮	uj	su
鳝	uj	yu
苫	uj	cv
鄯	uj	eu
芟	uj	cu
嬗	uj	nd
埏	uj	ty
汕	uj	du
晱	uj	oy
姗	uj	nc
潸	uj	do
跚	uj	zc
蟮	uj	iu
烻	uj	hy
栅	uj	mc
舢	uj	vu
墡	uj	tu
嶦	uj	uv
𫮃	uj	td
上	uh	aa
商	uh	wk
伤	uh	rl
熵	uh	hu
尚	uh	xk
赏	uh	bk
殇	uh	dy
觞	uh	jy
墒	uh	tu
垧	uh	tx
晌	uh	ox
绱	uh	su
少	uk	xp
烧	uk	hy
稍	uk	hx
勺	uk	gd
捎	uk	fx
哨	uk	kx
邵	uk	ev
绍	uk	sv
梢	uk	mx
苕	uk	cv
韶	uk	yv
蛸	uk	ix
劭	uk	lv
潲	uk	du
艄	uk	vx
芍	uk	cu
筲	uk	vx
召	uk	dk
睄	uk	ox
柖	uk	mv
玿	uk	wv
社	ue	ut
蛇	ue	it
设	ue	yu
射	ue	cu
舌	ue	qk
舍	ue	ru
摄	ue	fn
涉	ue	db
赦	ue	iw
折	ue	fj
奢	ue	dv
赊	ue	bu
佘	ue	ru
慑	ue	xn
麝	ue	lu
歙	ue	qx
畲	ue	rt
滠	ue	dn
厍	ue	ii
拾	ue	fh
猞	ue	qu
𪨶	ue	ui
谁	uz	yv
神	uf	uu
深	uf	dm
身	uf	pp
申	uf	aa
肾	uf	oy
沈	uf	dg
甚	uf	qa
审	uf	bu
伸	uf	ru
什	uf	ru
砷	uf	uu
慎	uf	xv
婶	uf	nu
渗	uf	dc
侁	uf	rx
诜	uf	yx
哂	uf	kx
蜃	uf	ii
莘	uf	cx
绅	uf	su
瘆	uf	bc
甡	uf	uu
燊	uf	hm
椹	uf	mu
矧	uf	uy
呻	uf	ku
屾	uf	uu
胂	uf	ou
珅	uf	wu
谂	uf	yn
鲹	uf	yc
娠	uf	ni
瞫	uf	ot
𬬹	uf	ju
𬳽	uf	mx
生	ug	na
声	ug	um
省	ug	ou
升	ug	pc
胜	ug	ou
圣	ug	ty
剩	ug	di
绳	ug	sd
昇	ug	ou
笙	ug	vu
牲	ug	nu
甥	ug	un
陞	ug	et
嵊	ug	ui
眚	ug	ou
是	ui	op
时	ui	oc
式	ui	gy
使	ui	rl
师	ui	ab
事	ui	aa
史	ui	ad
诗	ui	ys
市	ui	wj
屎	ui	um
十	ui	aa
视	ui	ju
室	ui	bv
试	ui	yu
实	ui	bt
饰	ui	uj
士	ui	aa
氏	ui	pg
湿	ui	dx
食	ui	rl
势	ui	lv
世	ui	ca
尸	ui	ap
失	ui	pf
施	ui	fy
始	ui	nt
识	ui	yv
适	ui	zu
狮	ui	qu
矢	ui	pd
嗜	ui	ko
谥	ui	yy
誓	ui	yv
弑	ui	iu
恃	ui	xs
示	ui	ex
释	ui	pf
仕	ui	ru
侍	ui	rs
逝	ui	zv
蚀	ui	ui
奭	ui	db
豕	ui	ad
轼	ui	iu
噬	ui	ku
虱	ui	iy
拭	ui	fu
祏	ui	uu
柿	ui	mu
铈	ui	ju
莳	ui	cu
驶	ui	mu
似	ui	ry
舐	ui	uu
筮	ui	vw
湜	ui	du
栻	ui	mu
螫	ui	iu
贳	ui	bu
蓍	ui	co
酾	ui	yl
炻	ui	hu
鲥	ui	yu
鼫	ui	uu
媞	ui	nu
埘	ui	tu
鸤	ui	nu
嘘	ui	kx
鲺	ui	yi
峙	ui	us
殖	ui	dv
襫	ui	yb
邿	ui	es
浉	ui	du
䏡	ui	ou
䴓	ui	nz
𫚕	ui	yu
𬤊	ui	yu
受	ub	vy
手	ub	pa
收	ub	wj
首	ub	qz
瘦	ub	bs
守	ub	bc
兽	ub	ka
寿	ub	cf
售	ub	kv
授	ub	fu
熟	ub	hu
艏	ub	vu
绶	ub	su
狩	ub	qu
书	uu	ad
数	uu	wl
树	uu	md
属	uu	uy
输	uu	iy
术	uu	md
叔	uu	yx
蜀	uu	si
竖	uu	ly
鼠	uu	ju
舒	uu	yu
疏	uu	pi
梳	uu	mi
赎	uu	bm
束	uu	ad
孰	uu	wx
述	uu	zu
黍	uu	hu
署	uu	sv
姝	uu	nv
塾	uu	tu
恕	uu	xr
淑	uu	du
庶	uu	gd
戍	uu	gd
漱	uu	dq
殊	uu	dv
暑	uu	ov
殳	uu	jy
曙	uu	ou
薯	uu	cu
抒	uu	fy
枢	uu	mq
蔬	uu	cu
菽	uu	cu
澍	uu	dc
倏	uu	rq
摅	uu	fl
腧	uu	oy
墅	uu	ty
纾	uu	sy
隃	uu	ey
秫	uu	hu
沭	uu	du
婌	uu	nu
陎	uu	ev
毹	uu	my
鄃	uu	ey
𬬸	uu	ju
刷	uw	dj
耍	uw	ne
唰	uw	ku
帅	uy	aj
甩	uy	pg
摔	uy	fl
衰	uy	yv
蟀	uy	il
涮	ur	du
栓	ur	mq
拴	ur	fq
闩	ur	ma
腨	ur	oe
双	ud	yy
爽	ud	dy
霜	ud	yx
孀	ud	nu
鹴	ud	nu
骦	ud	mu
礵	ud	uu
水	uv	ad
睡	uv	oi
税	uv	hd
帨	uv	jd
说	uv	yd
顺	up	yi
舜	up	vf
瞬	up	ou
吮	up	ky
楯	up	md
硕	uo	uy
朔	uo	on
槊	uo	mo
烁	uo	hl
搠	uo	fo
铄	uo	jl
妁	uo	nu
蒴	uo	co
四	si	aa
死	si	db
斯	si	jq
撕	si	fs
丝	si	aa
寺	si	ct
思	si	tx
私	si	hs
司	si	gk
嗣	si	ks
饲	si	us
巳	si	ag
嘶	si	ks
肆	si	yi
祀	si	us
姒	si	ny
驷	si	ms
锶	si	js
泗	si	ds
厮	si	is
兕	si	ea
笥	si	vs
汜	si	ds
咝	si	ks
鸶	si	ns
涘	si	dy
缌	si	ss
耜	si	lg
澌	si	ds
蛳	si	iu
虒	si	ph
飔	si	fs
凘	si	ds
㟃	si	us
楒	si	ms
送	ss	zg
宋	ss	bm
松	ss	mg
怂	ss	xc
颂	ss	yg
诵	ss	yy
崧	ss	us
耸	ss	ec
菘	ss	cs
嵩	ss	ug
竦	ss	lu
淞	ss	ds
讼	ss	yg
娀	ss	nr
凇	ss	ds
悚	ss	xu
𪨊	ss	uc
忪	ss	xg
㧐	ss	fu
搜	sb	fs
艘	sb	vs
嗖	sb	ks
馊	sb	us
叟	sb	jy
廋	sb	gs
薮	sb	cu
溲	sb	ds
瞍	sb	os
嗽	sb	kq
蒐	sb	cg
飕	sb	fs
嗾	sb	kz
擞	sb	fu
锼	sb	js
螋	sb	is
苏	su	cb
酥	su	yh
素	su	sf
速	su	zu
俗	su	rg
诉	su	yi
宿	su	bb
粟	su	mx
溯	su	do
塑	su	to
肃	su	ad
稣	su	yh
谡	su	yj
愫	su	xs
夙	su	jd
甦	su	gu
涑	su	du
窣	su	xz
骕	su	ms
蔌	su	cq
嗉	su	ks
簌	su	vq
傃	su	rs
鹔	su	ns
蹜	su	zs
缩	su	ss
僳	su	rs
觫	su	ju
𫗧	su	uu
算	sr	vc
酸	sr	yj
蒜	sr	cs
狻	sr	qw
岁	sv	ux
随	sv	ey
虽	sv	ki
遂	sv	zu
碎	sv	uz
隋	sv	eo
穗	sv	hh
髓	sv	gs
燧	sv	hs
隧	sv	es
睢	sv	ov
绥	sv	st
祟	sv	iu
荽	sv	ct
谇	sv	yz
眭	sv	og
濉	sv	ds
邃	sv	zu
旞	sv	fs
穟	sv	hs
璲	sv	ws
襚	sv	ys
𫟦	sv	is
𬭼	sv	js
孙	sp	zx
损	sp	fy
隼	sp	uv
榫	sp	ms
笋	sp	vy
飧	sp	ux
荪	sp	cs
狲	sp	qs
所	so	hj
锁	so	jb
索	so	sb
嗦	so	ks
梭	so	mj
娑	so	nu
蓑	so	cu
唆	so	kj
琐	so	wb
羧	so	yj
睃	so	ow
溹	so	ds
唢	so	kb
嗍	so	ko
桫	so	mu
他	ta	ry
她	ta	ny
它	ta	bb
塔	ta	td
塌	ta	ty
踏	ta	zt
祂	ta	uy
挞	ta	fd
拓	ta	fu
铊	ta	jt
榻	ta	my
牠	ta	ny
趿	ta	zj
獭	ta	qf
闼	ta	md
蹋	ta	zy
鳎	ta	yy
溻	ta	dy
遢	ta	zy
鞳	ta	gd
阘	ta	my
褟	ta	yy
太	tl	dd
台	tl	sk
态	tl	xt
胎	tl	ot
抬	tl	ft
泰	tl	fu
钛	tl	jt
肽	tl	ot
苔	tl	ct
汰	tl	dt
鲐	tl	yt
邰	tl	et
酞	tl	yt
薹	tl	ct
跆	tl	zt
炱	tl	ht
谈	tj	yy
碳	tj	ut
摊	tj	fn
贪	tj	bj
痰	tj	by
探	tj	fm
谭	tj	yt
叹	tj	ky
滩	tj	dn
坛	tj	ty
坦	tj	td
炭	tj	uh
瘫	tj	bn
潭	tj	dt
檀	tj	md
毯	tj	my
昙	tj	oy
钽	tj	jd
倓	tj	ry
忐	tj	xu
郯	tj	ey
坍	tj	td
璮	tj	wd
惔	tj	xy
菼	tj	cy
袒	tj	yd
锬	tj	jy
榃	tj	lt
磹	tj	ut
糖	th	mt
汤	th	dy
唐	th	gk
躺	th	uu
烫	th	ht
堂	th	tk
趟	th	zu
棠	th	dd
淌	th	du
塘	th	tt
倘	th	ru
膛	th	ot
蹚	th	zt
帑	th	jn
樘	th	mt
镗	th	jt
傥	th	rd
溏	th	dt
螳	th	it
镋	th	jd
搪	th	ft
羰	th	yt
嘡	th	kt
螗	th	it
瑭	th	wt
鄌	th	et
耥	th	lu
埫	th	tu
铴	th	jt
䣘	th	et
套	tk	di
淘	tk	df
逃	tk	zv
掏	tk	ff
讨	tk	yc
桃	tk	mv
陶	tk	ef
韬	tk	wj
涛	tk	du
弢	tk	gy
饕	tk	uh
绦	tk	st
绹	tk	st
洮	tk	dv
滔	tk	dj
萄	tk	cf
焘	tk	hu
梼	tk	mu
慆	tk	xy
啕	tk	kf
鼗	tk	gv
𫘦	tk	mf
特	te	ns
铽	te	jt
慝	te	xn
忑	te	xx
忒	te	xy
疼	tg	bd
藤	tg	ct
腾	tg	om
滕	tg	ou
熥	tg	ht
誊	tg	jy
縢	tg	os
螣	tg	oi
䲢	tg	ox
题	ti	uy
体	ti	rb
踢	ti	zy
替	ti	of
剃	ti	dd
缇	ti	su
梯	ti	md
锑	ti	jd
蹄	ti	zd
剔	ti	dy
啼	ti	kd
悌	ti	xd
涕	ti	dd
薙	ti	cv
惕	ti	xy
醍	ti	yu
屉	ti	uu
鳀	ti	yu
嚏	ti	kp
荑	ti	cy
趯	ti	zd
鹈	ti	nd
擿	ti	fu
绨	ti	sd
倜	ti	rv
裼	ti	yy
逖	ti	zd
瑅	ti	wu
遆	ti	zd
䏲	ti	od
䴘	ti	ns
𫘨	ti	mu
天	tm	ad
甜	tm	ug
填	tm	tv
田	tm	aa
舔	tm	ut
添	tm	dt
忝	tm	tx
湉	tm	dt
殄	tm	dp
恬	tm	xu
腆	tm	od
阗	tm	mv
掭	tm	ft
觍	tm	jd
瑱	tm	wv
沺	tm	dt
畋	tm	tw
淟	tm	dd
晪	tm	od
盷	tm	oy
黇	tm	hv
条	tc	wm
跳	tc	zv
挑	tc	fv
祧	tc	uv
蜩	tc	iv
窕	tc	xv
朓	tc	ov
鲦	tc	yt
粜	tc	im
佻	tc	rv
眺	tc	ov
嬥	tc	nd
髫	tc	iv
迢	tc	zv
笤	tc	vv
龆	tc	iv
贴	tx	bv
铁	tx	ju
帖	tx	jv
萜	tx	ct
餮	tx	du
听	ty	kj
挺	ty	ft
停	ty	rt
厅	ty	id
亭	ty	wd
汀	ty	dd
艇	ty	vt
庭	ty	gt
廷	ty	zr
霆	ty	yt
婷	ty	nt
烃	ty	hg
铤	ty	jt
珽	ty	wt
梃	ty	mt
渟	ty	dt
葶	ty	ct
蜓	ty	it
莛	ty	ct
圢	ty	td
桯	ty	mi
颋	ty	yt
侹	ty	rt
烶	ty	ht
䗴	ty	it
𬘩	ty	st
同	ts	kk
通	ts	zy
痛	ts	by
铜	ts	jt
桶	ts	my
捅	ts	fy
筒	ts	vt
酮	ts	yt
佟	ts	rd
统	ts	si
童	ts	ll
瞳	ts	ot
桐	ts	mt
彤	ts	pd
砼	ts	ug
嗵	ts	kt
僮	ts	rt
恸	ts	xd
仝	ts	rg
穜	ts	ht
潼	ts	dt
烔	ts	ht
橦	ts	mt
茼	ts	ct
曈	ts	ot
哃	ts	kt
鲖	ts	yt
㛚	ts	ny
峂	ts	ud
𦒍	ts	yt
𫍣	ts	yt
头	tb	dd
投	tb	fu
偷	tb	ry
透	tb	zx
骰	tb	gu
图	tu	kd
土	tu	aa
吐	tu	kt
涂	tu	dy
兔	tu	dd
突	tu	xq
屠	tu	uv
徒	tu	xz
凸	tu	aa
秃	tu	hj
途	tu	zy
荼	tu	cy
钍	tu	jt
酴	tu	yy
菟	tu	ct
凃	tu	dy
稌	tu	hy
堍	tu	tt
腯	tu	od
梌	tu	my
葖	tu	ct
㻬	tu	wy
𬳿	tu	my
团	tr	kc
彖	tr	ad
抟	tr	fv
湍	tr	de
猯	tr	qe
疃	tr	tt
煓	tr	he
推	tv	fv
腿	tv	ot
退	tv	zg
褪	tv	yt
颓	tv	yt
蜕	tv	id
煺	tv	ht
魋	tv	gv
𬯎	tv	eg
臀	tp	od
吞	tp	kt
屯	tp	ag
豚	tp	ou
鲀	tp	yt
暾	tp	od
焞	tp	hx
饨	tp	ut
坉	tp	tt
忳	tp	xt
拖	to	fy
托	to	fq
脱	to	od
坨	to	tt
陀	to	et
驼	to	mt
妥	to	vn
佗	to	rt
侂	to	rq
唾	to	ki
橐	to	am
沱	to	dt
鼍	to	kd
鸵	to	nt
椭	to	md
萚	to	cz
砣	to	ut
柁	to	mt
箨	to	vz
柝	to	mi
跎	to	zt
酡	to	yt
圫	to	tq
庹	to	gi
𬶍	to	yt
哇	wa	kg
挖	wa	fw
娃	wa	ng
瓦	wa	ad
蛙	wa	ig
袜	wa	ym
洼	wa	dg
娲	wa	ng
佤	wa	rw
窊	wa	xg
坬	wa	tg
腽	wa	om
畖	wa	tg
外	wl	xb
歪	wl	bv
崴	wl	uw
玩	wj	wy
完	wj	by
晚	wj	om
碗	wj	uw
弯	wj	gy
丸	wj	jd
湾	wj	dw
挽	wj	fm
纨	wj	sw
绾	wj	sg
烷	wj	hw
腕	wj	ow
剜	wj	dw
皖	wj	bw
菀	wj	cw
卍	wj	aa
宛	wj	be
顽	wj	yy
豌	wj	dw
婉	wj	nw
脘	wj	ow
畹	wj	tw
椀	wj	mw
芄	wj	cw
婠	wj	ng
琬	wj	ww
惋	wj	xw
蜿	wj	iw
塆	wj	tw
𬇕	wj	dw
往	wh	xv
王	wh	aa
网	wh	ki
望	wh	wo
忘	wh	xw
汪	wh	dw
亡	wh	da
旺	wh	ow
妄	wh	nw
枉	wh	mw
罔	wh	kw
辋	wh	iw
惘	wh	xw
尢	wh	ag
魍	wh	gw
尪	wh	yw
为	wz	dd
位	wz	rl
未	wz	ex
味	wz	kw
微	wz	xw
喂	wz	kw
伪	wz	rw
胃	wz	ot
维	wz	sv
威	wz	gn
魏	wz	gw
唯	wz	kv
尾	wz	um
卫	wz	ea
谓	wz	yw
韦	wz	aa
围	wz	kw
惟	wz	xv
薇	wz	cw
委	wz	hn
危	wz	de
煨	wz	hw
畏	wz	ty
伟	wz	rw
隈	wz	ew
违	wz	zw
苇	wz	cw
萎	wz	cw
炜	wz	hw
慰	wz	xw
尉	wz	cu
纬	wz	sw
鲔	wz	yy
蔚	wz	cw
圩	wz	ty
洧	wz	dy
玮	wz	ww
艉	wz	vw
帷	wz	jv
渭	wz	dw
帏	wz	jw
桅	wz	mw
猥	wz	qw
痿	wz	bw
廆	wz	gg
巍	wz	uw
嵬	wz	ug
猬	wz	qw
薳	wz	cy
鳚	wz	yw
潍	wz	dw
亹	wz	dq
葳	wz	cw
偎	wz	rw
闱	wz	mw
诿	wz	yw
韪	wz	uw
娓	wz	nw
隗	wz	eg
溦	wz	dw
沩	wz	dw
硙	wz	uq
煟	wz	hw
逶	wz	zw
霨	wz	yw
碨	wz	uw
涠	wz	dw
洈	wz	dw
琟	wz	wv
峗	wz	uw
螱	wz	iw
鳂	wz	yw
𣲗	wz	dw
𫇭	wz	cw
𬀩	wz	ow
𬱟	wz	yw
𬶏	wz	yw
问	wf	km
文	wf	wi
稳	wf	hj
闻	wf	em
纹	wf	sw
温	wf	dm
吻	wf	kw
蚊	wf	iw
瘟	wf	bm
玟	wf	ww
雯	wf	yw
汶	wf	dw
炆	wf	hw
辒	wf	iw
刎	wf	dw
阌	wf	mu
紊	wf	sw
蕰	wf	cw
榅	wf	mw
芠	wf	cw
鳁	wf	yw
璺	wf	jy
𫘜	wf	mw
翁	wg	yg
嗡	wg	kw
瓮	wg	wg
滃	wg	dw
蓊	wg	cw
蕹	wg	cv
鹟	wg	nw
𬭩	wg	jw
我	wo	pd
窝	wo	xn
握	wo	fw
沃	wo	dy
卧	wo	bi
斡	wo	du
倭	wo	rw
龌	wo	iw
渥	wo	dw
偓	wo	rw
肟	wo	ok
蜗	wo	ig
挝	wo	fg
幄	wo	jw
硪	wo	uw
涴	wo	dw
莴	wo	cg
踒	wo	zw
五	wu	aa
物	wu	nw
吾	wu	wk
吴	wu	kt
勿	wu	gp
乌	wu	pa
舞	wu	rf
武	wu	vy
屋	wu	uv
误	wu	yw
悟	wu	xw
唔	wu	kw
雾	wu	yw
捂	wu	fw
伍	wu	rw
戊	wu	ap
污	wu	dk
兀	wu	ae
呜	wu	kw
巫	wu	gc
午	wu	pu
务	wu	wl
钨	wu	jw
坞	wu	tw
毋	wu	ap
邬	wu	ew
诬	wu	yw
寤	wu	bw
庑	wu	gw
侮	wu	rm
芜	wu	cw
焐	wu	hw
旿	wu	ow
忤	wu	xw
鹜	wu	nm
鼯	wu	uw
晤	wu	ow
骛	wu	mm
梧	wu	mw
迕	wu	zw
杌	wu	mw
鹀	wu	nw
圬	wu	tk
妩	wu	nw
怃	wu	xw
芴	wu	cw
洿	wu	dk
浯	wu	dw
珷	wu	ww
婺	wu	nm
鋈	wu	jw
屼	wu	uw
鹉	wu	nw
铻	wu	jw
珸	wu	ww
蜈	wu	iw
牾	wu	nw
郚	wu	ew
仵	wu	rw
痦	wu	bw
靰	wu	gw
峿	wu	uw
𣲘	wu	dm
洗	xi	dx
戏	xi	yg
西	xi	aa
细	xi	st
吸	xi	kj
喜	xi	uk
兮	xi	bk
希	xi	ju
席	xi	jc
膝	xi	oq
稀	xi	hx
锡	xi	jy
息	xi	xz
奚	xi	vd
习	xi	ga
硒	xi	ux
昔	xi	co
惜	xi	xx
溪	xi	dx
袭	xi	ly
徙	xi	xb
悉	xi	xm
析	xi	mj
曦	xi	ox
玺	xi	we
隙	xi	ex
熄	xi	hx
蜥	xi	ix
夕	xi	pd
汐	xi	dx
熙	xi	hs
嘻	xi	kx
檄	xi	mj
铣	xi	jx
羲	xi	yg
晞	xi	ox
烯	xi	hx
豨	xi	ux
晰	xi	ox
犀	xi	nu
禧	xi	ux
隰	xi	ed
嬉	xi	nx
釐	xi	lw
郤	xi	eg
咥	xi	kv
谿	xi	gx
郗	xi	ex
牺	xi	nx
禊	xi	uq
翕	xi	yh
僖	xi	rx
熹	xi	dx
觋	xi	jw
皙	xi	bx
醯	xi	ym
媳	xi	nx
枲	xi	mt
嶲	xi	ug
饩	xi	uq
傒	xi	rx
憙	xi	xx
唏	xi	kx
舄	xi	jd
浠	xi	dx
舾	xi	vx
淅	xi	dx
螅	xi	ix
肸	xi	ou
屣	xi	uv
觿	xi	jj
酅	xi	ej
穸	xi	xx
屃	xi	ub
蓰	xi	cv
菥	xi	cx
潟	xi	dd
鳛	xi	yb
绤	xi	sg
鼷	xi	ux
阋	xi	me
蟋	xi	ix
葸	xi	cs
樨	xi	mx
爔	xi	hx
巇	xi	ug
睎	xi	ox
熻	xi	hx
粞	xi	mx
窸	xi	xx
俙	xi	rx
恓	xi	xx
嶍	xi	ub
暿	xi	ox
饻	xi	uy
𠅤	xi	ws
𫘬	xi	mx
𬭳	xi	jx
𬶮	xi	yx
下	xw	ab
瞎	xw	oh
夏	xw	wz
侠	xw	rj
虾	xw	ix
霞	xw	yj
狭	xw	qj
峡	xw	uj
瑕	xw	wj
匣	xw	kj
辖	xw	ih
呷	xw	kj
叚	xw	ad
暇	xw	oj
狎	xw	qj
遐	xw	zj
硖	xw	uj
罅	xw	fh
柙	xw	mj
黠	xw	hj
翈	xw	jy
先	xm	ne
线	xm	sj
险	xm	ea
弦	xm	gx
现	xm	wj
县	xm	sq
嫌	xm	nj
仙	xm	ru
咸	xm	gk
显	xm	oy
鲜	xm	yy
限	xm	eg
闲	xm	mm
藓	xm	cx
馅	xm	uj
献	xm	qn
贤	xm	by
掀	xm	fx
陷	xm	ej
酰	xm	yx
衔	xm	ri
氙	xm	qu
腺	xm	oq
娴	xm	nx
羡	xm	yc
霰	xm	ys
筅	xm	vx
宪	xm	bx
籼	xm	mu
蚬	xm	ij
舷	xm	vx
涎	xm	dy
冼	xm	dx
岘	xm	uj
苋	xm	cj
狝	xm	qe
跣	xm	zx
燹	xm	hu
锨	xm	jx
祆	xm	ut
暹	xm	zv
痫	xm	bx
缐	xm	sq
猃	xm	qa
伭	xm	rx
崄	xm	ua
跹	xm	zq
莶	xm	ca
挦	xm	fx
孅	xm	ng
忺	xm	xq
鹇	xm	nx
禒	xm	ut
㬎	xm	oh
𪾢	xm	oj
𫍯	xm	yx
𬀪	xm	oj
𬸣	xm	bn
想	xd	xx
像	xd	rx
向	xd	pk
项	xd	gy
香	xd	ho
相	xd	mo
象	xd	du
箱	xd	vx
乡	xd	ap
响	xd	kx
翔	xd	yy
橡	xd	mx
享	xd	dz
湘	xd	dx
祥	xd	uy
镶	xd	jx
厢	xd	ix
饷	xd	ux
详	xd	yy
飨	xd	ux
襄	xd	dy
芗	xd	cx
庠	xd	gy
骧	xd	mx
缃	xd	sx
鲞	xd	jy
瓖	xd	wx
珦	xd	wx
葙	xd	cx
𬙋	xd	sx
小	xc	ad
笑	xc	vy
肖	xc	ox
箫	xc	vs
孝	xc	zl
逍	xc	zx
萧	xc	cs
消	xc	dx
削	xc	dx
晓	xc	oy
枭	xc	mn
效	xc	wj
销	xc	jx
鸮	xc	nh
宵	xc	bx
骁	xc	my
魈	xc	gx
硝	xc	ux
咲	xc	kg
崤	xc	uy
啸	xc	ks
枵	xc	mh
筱	xc	vw
绡	xc	sx
霄	xc	yx
潇	xc	dx
嚣	xc	kk
虓	xc	jh
翛	xc	ry
猇	xc	qh
淆	xc	dy
皛	xc	bb
哓	xc	ky
哮	xc	kx
洨	xc	dj
涍	xc	dx
滧	xc	dx
蟏	xc	ix
敩	xc	wx
𫍲	xc	ys
写	xx	by
些	xx	ec
鞋	xx	gg
血	xx	pa
谢	xx	yu
斜	xx	dy
蟹	xx	ij
邪	xx	ey
携	xx	fj
卸	xx	ea
歇	xx	qh
屑	xx	ux
挟	xx	fj
协	xx	ub
泻	xx	dx
泄	xx	du
蝎	xx	ih
偕	xx	rj
械	xx	mj
燮	xx	hy
谐	xx	yj
胁	xx	ob
榭	xx	mu
楔	xx	mq
懈	xx	xj
薤	xx	ca
澥	xx	dj
亵	xx	dy
缬	xx	sj
绁	xx	su
撷	xx	fj
獬	xx	qj
廨	xx	gj
渫	xx	dm
薢	xx	cj
勰	xx	ls
偰	xx	rq
瀣	xx	da
邂	xx	zj
揳	xx	fq
叶	xx	ku
躞	xx	zx
榍	xx	mx
㙦	xx	tx
𤫉	xx	wx
𬹼	xx	qj
新	xn	jq
心	xn	dd
信	xn	ry
芯	xn	cx
辛	xn	lu
锌	xn	jx
薪	xn	cx
欣	xn	qj
鑫	xn	jj
昕	xn	oj
馨	xn	ux
忻	xn	xj
歆	xn	qy
衅	xn	xb
炘	xn	hj
囟	xn	pa
伈	xn	rx
䜣	xn	yj
𫷷	xn	gq
型	xy	tx
性	xy	xu
星	xy	ou
形	xy	pk
姓	xy	nu
醒	xy	yx
兴	xy	ba
邢	xy	ek
刑	xy	dk
幸	xy	tu
杏	xy	km
腥	xy	ox
陉	xy	eg
擤	xy	fb
荇	xy	cx
饧	xy	uy
猩	xy	qx
骍	xy	mx
煋	xy	hx
铏	xy	jx
婞	xy	nx
惺	xy	xx
荥	xy	cu
悻	xy	xx
钘	xy	jk
瑆	xy	wx
硎	xy	ux
𫰛	xy	ng
胸	xs	ox
熊	xs	dn
凶	xs	ik
兄	xs	ke
雄	xs	vh
匈	xs	gx
芎	xs	cg
夐	xs	dw
讻	xs	yx
汹	xs	dx
诇	xs	yj
修	xq	rp
秀	xq	hn
休	xq	rm
绣	xq	sx
嗅	xq	ki
溴	xq	di
袖	xq	yy
锈	xq	jx
羞	xq	yi
咻	xq	kx
岫	xq	uy
脩	xq	ro
朽	xq	mk
髹	xq	ix
琇	xq	wx
貅	xq	vx
庥	xq	gx
滫	xq	do
鸺	xq	nx
珛	xq	wy
馐	xq	ux
䗛	xq	ix
需	xu	ye
虚	xu	hy
须	xu	py
徐	xu	xy
许	xu	yw
续	xu	sm
序	xu	gy
叙	xu	yy
恤	xu	xx
蓄	xu	ci
旭	xu	oj
绪	xu	sv
絮	xu	sr
墟	xu	tx
胥	xu	op
栩	xu	my
诩	xu	yy
吁	xu	ky
婿	xu	nx
昫	xu	oj
煦	xu	dx
媭	xu	nx
勖	xu	lm
蓿	xu	cs
盱	xu	oy
酗	xu	yx
顼	xu	wy
糈	xu	mx
溆	xu	dx
洫	xu	dx
湑	xu	dx
醑	xu	yx
旴	xu	oy
垿	xu	tx
魆	xu	gy
谞	xu	yx
珝	xu	wy
㳚	xu	du
冔	xu	oy
𦈡	xu	sx
𬣙	xu	yy
选	xr	zx
悬	xr	xx
癣	xr	bx
炫	xr	hx
玄	xr	wy
宣	xr	bg
轩	xr	ig
旋	xr	fp
泫	xr	dx
萱	xr	cx
璇	xr	wx
渲	xr	dx
喧	xr	kx
玹	xr	wx
烜	xr	hg
铉	xr	jx
瑄	xr	wx
漩	xr	dx
暄	xr	ox
谖	xr	yy
绚	xr	sx
楦	xr	mx
衒	xr	xi
煊	xr	hx
眩	xr	ox
咺	xr	kg
儇	xr	rh
禤	xr	uy
晅	xr	og
翾	xr	yh
碹	xr	ux
昡	xr	ox
琄	xr	wo
痃	xr	bx
暶	xr	ox
愃	xr	xx
𫍽	xr	yh
𫓶	xr	jj
𫠊	xr	mx
学	xt	dz
雪	xt	yx
薛	xt	cx
靴	xt	gh
穴	xt	bb
谑	xt	yn
噱	xt	kj
鳕	xt	yx
踅	xt	zv
茓	xt	cx
峃	xt	du
薰	xp	cx
寻	xp	cx
熏	xp	ha
训	xp	yi
逊	xp	zs
巡	xp	zi
埙	xp	ty
勋	xp	ly
巽	xp	gs
讯	xp	yu
荀	xp	cx
循	xp	xd
旬	xp	go
殉	xp	dx
洵	xp	dx
询	xp	yx
迅	xp	zu
徇	xp	xx
驯	xp	mi
蕈	xp	ct
浔	xp	dx
鲟	xp	yx
恂	xp	xx
醺	xp	yx
栒	xp	mx
曛	xp	ox
獯	xp	qx
汛	xp	du
珣	xp	wx
噀	xp	kg
峋	xp	ux
𫄸	xp	sx
𬊈	xp	hx
𬍤	xp	wx
𬘓	xp	si
𬩽	xp	ex
呀	ya	ky
牙	ya	ap
压	ya	id
鸭	ya	nj
亚	ya	ay
雅	ya	vy
押	ya	fj
丫	ya	ba
芽	ya	cy
娅	ya	ny
崖	ya	uy
哑	ya	ky
鸦	ya	ny
氩	ya	qy
涯	ya	dy
伢	ya	ry
衙	ya	ri
蚜	ya	iy
垭	ya	ty
猰	ya	qq
玡	ya	wy
琊	ya	wx
砑	ya	uy
桠	ya	my
迓	ya	zy
讶	ya	yy
揠	ya	fn
睚	ya	oy
岈	ya	uy
堐	ya	ty
盐	yj	mb
眼	yj	og
演	yj	dy
烟	yj	hy
言	yj	da
沿	yj	dk
研	yj	uk
焉	yj	vd
严	yj	ap
颜	yj	yy
燕	yj	ch
宴	yj	bn
炎	yj	hh
岩	yj	uu
验	yj	ma
咽	yj	ky
延	yj	zv
彦	yj	dp
阎	yj	mj
掩	yj	fd
厌	yj	iq
艳	yj	fs
闫	yj	ms
焰	yj	hj
晏	yj	oa
淹	yj	dd
俨	yj	ry
妍	yj	nk
雁	yj	iv
鄢	yj	ey
魇	yj	gy
嫣	yj	ny
阏	yj	my
檐	yj	mv
偃	yj	rn
焱	yj	hh
衍	yj	ri
阉	yj	md
砚	yj	uj
甗	yj	wg
兖	yj	ly
谳	yj	yx
筵	yj	vy
罨	yj	sd
赝	yj	by
弇	yj	ch
湮	yj	dt
酽	yj	yy
琰	yj	wy
奄	yj	dd
堰	yj	tn
餍	yj	iu
郾	yj	en
滟	yj	dy
沇	yj	dy
芫	yj	cy
谚	yj	yy
黡	yj	hy
嬿	yj	ny
唁	yj	ky
胭	yj	oy
蜒	yj	iy
渰	yj	dc
墕	yj	ty
棪	yj	my
戭	yj	gy
掞	yj	fy
蝘	yj	in
鼹	yj	ua
崦	yj	ud
厣	yj	ij
殷	yj	pu
恹	yj	xy
漹	yj	dy
虤	yj	hh
扊	yj	hy
䶮	yj	lt
觃	yj	jz
𪩘	yj	ux
𫄧	yj	sy
𬙂	yj	sy
𬸘	yj	ny
杨	yh	my
养	yh	ya
羊	yh	da
样	yh	my
氧	yh	qy
阳	yh	eo
痒	yh	by
洋	yh	dy
扬	yh	fy
央	yh	ad
仰	yh	re
鞅	yh	gy
漾	yh	dy
旸	yh	oy
羕	yh	yy
秧	yh	hy
佯	yh	ry
烊	yh	hy
殃	yh	dy
飏	yh	fy
炀	yh	hy
钖	yh	jy
疡	yh	by
玚	yh	wy
鸯	yh	ny
恙	yh	xy
垟	yh	ty
蛘	yh	iy
泱	yh	dy
怏	yh	xy
徉	yh	xy
咉	yh	ky
要	yk	xn
药	yk	cy
腰	yk	oy
妖	yk	ny
咬	yk	kj
邀	yk	zj
摇	yk	ff
尧	yk	gw
姚	yk	nv
舀	yk	vj
幺	yk	ad
约	yk	su
曜	yk	od
谣	yk	yf
瑶	yk	wf
遥	yk	zf
窑	yk	xf
爻	yk	ii
垚	yk	tt
夭	yk	pd
耀	yk	gd
吆	yk	ky
杳	yk	mo
窈	yk	xy
峣	yk	uy
肴	yk	ou
徭	yk	xf
钥	yk	jo
鳐	yk	yf
窅	yk	xo
鹞	yk	nf
珧	yk	wv
轺	yk	iv
靿	yk	gy
崾	yk	uy
猺	yk	qf
媱	yk	nf
㙘	yk	ty
也	ye	gg
页	ye	ab
野	ye	ly
液	ye	dy
夜	ye	wd
耶	ye	ee
业	ye	aa
爷	ye	fe
噎	ye	ky
邺	ye	ey
谒	ye	yh
掖	ye	fy
椰	ye	my
曳	ye	ap
冶	ye	dt
腋	ye	oy
晔	ye	oh
烨	ye	hh
铘	ye	jx
靥	ye	im
倻	ye	ry
馌	ye	uh
揶	ye	fy
以	yi	rd
一	yi	aa
亿	yi	ry
已	yi	vg
亦	yi	wb
易	yi	ow
矣	yi	su
乙	yi	aa
译	yi	yf
伊	yi	ry
意	yi	xy
仪	yi	ry
依	yi	ry
咦	yi	ky
椅	yi	mq
衣	yi	dd
医	yi	ku
翼	yi	yg
义	yi	di
异	yi	cs
宜	yi	bq
裔	yi	yk
邑	yi	kb
壹	yi	ud
益	yi	mb
移	yi	hd
奕	yi	dy
夷	yi	ad
逸	yi	zt
役	yi	xu
艺	yi	cy
疑	yi	bp
忆	yi	xy
倚	yi	rq
姨	yi	ny
遗	yi	zg
议	yi	yy
噫	yi	ky
蚁	yi	iy
抑	yi	fe
胰	yi	oy
怡	yi	xt
乂	yi	pd
驿	yi	mf
溢	yi	dy
铱	yi	jy
翊	yi	ly
疫	yi	bu
埸	yi	ty
刈	yi	di
颐	yi	yi
懿	yi	yx
钇	yi	jy
诣	yi	yv
贻	yi	bt
毅	yi	lu
彝	yi	ac
猗	yi	qq
翳	yi	yu
揖	yi	fe
弋	yi	ad
轶	yi	iu
祎	yi	uw
羿	yi	cy
镒	yi	jy
佚	yi	ru
燚	yi	yy
谊	yi	yy
弈	yi	cy
诒	yi	yt
咿	yi	ky
扆	yi	hy
沂	yi	dj
镱	yi	jy
佾	yi	ro
浥	yi	db
臆	yi	oy
瘗	yi	bt
殪	yi	dy
缢	yi	sy
苡	yi	cy
峄	yi	uf
圯	yi	ts
绎	yi	sf
熠	yi	hb
迤	yi	zy
劓	yi	db
翌	yi	yl
挹	yi	fb
漪	yi	dq
饴	yi	ut
嶷	yi	uy
肄	yi	by
匜	yi	ky
屹	yi	uq
裛	yi	dy
潩	yi	dg
舣	yi	vy
薏	yi	cy
怿	yi	xf
踦	yi	zq
螠	yi	iy
簃	yi	vy
黟	yi	hd
旖	yi	fq
洢	yi	dy
繄	yi	su
佁	yi	rt
悒	yi	xb
嫕	yi	nx
鹢	yi	ny
勚	yi	lb
呓	yi	ky
眙	yi	ot
蜴	yi	iy
癔	yi	by
酏	yi	yy
鹝	yi	ng
廙	yi	gg
枍	yi	mx
痍	yi	by
杙	yi	my
宧	yi	bi
椸	yi	mu
扅	yi	hd
㑊	yi	ry
𫄷	yi	sy
𫖮	yi	yq
𬟁	yi	cn
𬬩	yi	jy
𬺈	yi	iq
因	yn	kd
音	yn	lo
银	yn	jg
印	yn	ey
引	yn	ga
饮	yn	uq
阴	yn	eo
隐	yn	ej
瘾	yn	by
胤	yn	pg
吟	yn	kj
尹	yn	ap
寅	yn	bb
荫	yn	cy
淫	yn	dr
龈	yn	ig
铟	yn	jy
茵	yn	cy
蚓	yn	iy
洇	yn	dy
鄞	yn	ej
愔	yn	xy
堙	yn	tt
骃	yn	my
喑	yn	ky
垠	yn	tg
窨	yn	xy
氤	yn	qy
禋	yn	ut
嚚	yn	ik
霪	yn	yy
姻	yn	ny
訚	yn	my
龂	yn	ij
崟	yn	uj
茚	yn	cy
慭	yn	xq
夤	yn	xb
溵	yn	dy
狺	yn	qy
蟫	yn	it
吲	yn	ky
硍	yn	ug
珢	yn	wg
歅	yn	qt
䲟	yn	yy
𬘡	yn	sy
𬤇	yn	yt
𬮱	yn	mt
应	yy	ga
硬	yy	ug
赢	yy	bk
英	yy	cy
营	yy	cl
樱	yy	my
影	yy	pj
嘤	yy	ky
鹰	yy	gn
迎	yy	ze
盈	yy	my
嬴	yy	nk
郢	yy	ei
瑛	yy	wy
蝇	yy	id
莺	yy	cn
颖	yy	hy
映	yy	oy
萤	yy	ci
婴	yy	bn
瀛	yy	dy
颍	yy	yu
莹	yy	cy
媵	yy	on
鹦	yy	ny
膺	yy	go
缨	yy	sy
瘿	yy	by
楹	yy	my
荧	yy	ch
萦	yy	cs
罂	yy	bf
撄	yy	fy
锳	yy	jy
滢	yy	dy
溁	yy	dr
潆	yy	dy
蓥	yy	cj
璎	yy	wy
茔	yy	ct
媖	yy	ny
䓨	yy	fb
哟	yo	ky
唷	yo	ky
育	yo	os
用	ys	kf
勇	ys	ly
永	ys	dd
咏	ys	ky
拥	ys	fy
庸	ys	ga
雍	ys	wv
蛹	ys	iy
颙	ys	yy
俑	ys	ry
佣	ys	ry
慵	ys	xy
泳	ys	dy
痈	ys	by
踊	ys	zy
壅	ys	dt
鄘	ys	ey
甬	ys	sy
镛	ys	jy
鳙	ys	yy
饔	ys	uv
邕	ys	ib
澭	ys	dv
臃	ys	ov
墉	ys	ty
喁	ys	ky
恿	ys	xy
埇	ys	ty
栐	ys	my
㶲	ys	hy
鲬	ys	yy
有	yb	ou
又	yb	vd
由	yb	aa
油	yb	dy
右	yb	ku
游	yb	dz
呦	yb	ky
优	yb	ry
友	yb	yu
尤	yb	ad
铀	yb	jy
鼬	yb	uy
祐	yb	uy
犹	yb	qy
佑	yb	ry
忧	yb	xy
幽	yb	uy
釉	yb	py
幼	yb	ly
邮	yb	ey
疣	yb	by
酉	yb	aa
悠	yb	xw
诱	yb	yx
柚	yb	my
宥	yb	by
攸	yb	rw
鱿	yb	yy
繇	yb	vx
囿	yb	ky
卣	yb	ba
侑	yb	ry
铕	yb	jy
牖	yb	pf
猷	yb	qq
蚴	yb	iy
莠	yb	cx
麀	yb	lb
羑	yb	yj
鲉	yb	yy
莜	yb	cw
黝	yb	hy
莸	yb	cy
耰	yb	ly
槱	yb	md
浟	yb	dw
蝣	yb	iz
蚰	yb	iy
𬨎	yb	iq
与	yu	aa
于	yu	aa
鱼	yu	da
宇	yu	by
於	yu	fd
欲	yu	gq
语	yu	yw
雨	yu	ad
余	yu	rb
预	yu	yy
御	yu	xx
玉	yu	ad
域	yu	th
羽	yu	xx
瑜	yu	wy
遇	yu	zy
禹	yu	pd
逾	yu	zy
愈	yu	xy
俞	yu	rd
予	yu	sa
虞	yu	hw
渔	yu	dy
渝	yu	dy
愚	yu	xy
豫	yu	yx
驭	yu	my
裕	yu	yg
喻	yu	ky
隅	yu	ey
郁	yu	ey
瘀	yu	by
狱	yu	qq
浴	yu	dg
舆	yu	ba
彧	yu	kp
娱	yu	nw
鹬	yu	nk
峪	yu	ug
芋	yu	cy
淤	yu	dy
誉	yu	yx
昱	yu	ol
欤	yu	qy
谕	yu	yy
寓	yu	by
榆	yu	my
鬻	yu	gv
毓	yu	mi
煜	yu	hy
愉	yu	xy
阈	yu	mh
圉	yu	kx
盂	yu	my
聿	yu	aa
瑀	yu	wy
鄅	yu	ey
迂	yu	zy
庾	yu	gy
屿	yu	uy
禺	yu	ad
竽	yu	vy
遹	yu	zk
淯	yu	dy
妤	yu	ny
窳	yu	xg
纡	yu	sy
钰	yu	jy
妪	yu	nq
鹆	yu	ng
俣	yu	rw
雩	yu	yk
棫	yu	mh
燠	yu	ha
腴	yu	oy
舁	yu	cj
玙	yu	wy
谀	yu	yy
矞	yu	mk
敔	yu	ww
饫	yu	uy
畬	yu	ty
熨	yu	hw
潏	yu	dk
堉	yu	ty
嵛	yu	uy
蜮	yu	ih
圄	yu	kw
艅	yu	vy
揄	yu	fy
萸	yu	cy
邘	yu	ey
臾	yu	jr
褕	yu	yy
燏	yu	hk
窬	yu	xy
髃	yu	gy
瘐	yu	by
龉	yu	iw
嵎	yu	uy
觎	yu	jy
狳	yu	qy
滪	yu	dy
伛	yu	rq
蝓	yu	iy
蓣	yu	cy
悆	yu	xy
㺄	yu	qy
元	yr	aw
原	yr	ix
远	yr	zy
源	yr	dy
圆	yr	ky
愿	yr	xy
院	yr	ew
员	yr	kb
园	yr	ky
袁	yr	ty
缘	yr	st
猿	yr	qy
怨	yr	xe
冤	yr	bt
苑	yr	ce
渊	yr	da
垣	yr	tg
爰	yr	vy
援	yr	fy
鸢	yr	ny
掾	yr	ft
鼋	yr	my
螈	yr	iy
沅	yr	dy
妧	yr	ny
媛	yr	ny
塬	yr	ty
瑗	yr	wy
鸳	yr	ne
嫄	yr	ny
辕	yr	iy
垸	yr	tw
橼	yr	my
蜎	yr	io
眢	yr	oe
湲	yr	dy
箢	yr	vw
羱	yr	yy
𫘪	yr	mr
月	yt	oy
越	yt	zy
曰	yt	aa
粤	yt	pk
岳	yt	uq
悦	yt	xd
阅	yt	md
钺	yt	jy
跃	yt	zy
玥	yt	wo
樾	yt	my
刖	yt	do
籥	yt	vc
龠	yt	rc
瀹	yt	dc
爚	yt	hc
彟	yt	xh
𫐄	yt	iw
𬸚	yt	ny
云	yp	es
运	yp	zy
晕	yp	oj
韵	yp	yy
孕	yp	zn
匀	yp	gd
允	yp	se
芸	yp	cy
陨	yp	ey
愠	yp	xm
蕴	yp	cm
殒	yp	dy
昀	yp	oy
妘	yp	ny
赟	yp	bb
狁	yp	qy
韫	yp	wm
恽	yp	xj
氲	yp	qm
缊	yp	sw
酝	yp	yy
郓	yp	ej
耘	yp	ly
郧	yp	ey
筼	yp	vy
煴	yp	hw
沄	yp	dy
纭	yp	sy
鋆	yp	jj
涢	yp	dy
馧	yp	xw
𫖳	yp	yj
咋	za	kv
砸	za	uz
杂	za	jm
咂	za	kz
匝	za	jk
扎	za	fg
拶	za	fx
臜	za	oz
在	zl	ta
再	zl	aa
载	zl	gi
哉	zl	kg
宰	zl	bx
崽	zl	us
仔	zl	rz
栽	zl	gm
灾	zl	bh
甾	zl	it
赞	zj	bx
咱	zj	kz
暂	zj	ov
簪	zj	vo
錾	zj	jv
瓒	zj	wz
昝	zj	oi
酂	zj	ez
趱	zj	zz
糌	zj	mo
寁	zj	bj
脏	zh	ov
葬	zh	cc
臧	zh	gi
牂	zh	py
赃	zh	bv
奘	zh	dv
驵	zh	mq
早	zk	ou
造	zk	zg
遭	zk	zc
灶	zk	ht
糟	zk	mc
枣	zk	cd
凿	zk	yk
澡	zk	dz
皂	zk	bq
燥	zk	hz
藻	zk	cz
躁	zk	zz
噪	zk	kz
蚤	zk	ii
慥	zk	xz
璪	zk	wz
簉	zk	vz
唣	zk	kz
𥖨	zk	uc
则	ze	bd
啧	ze	kz
泽	ze	df
择	ze	ff
责	ze	bf
仄	ze	ir
帻	ze	jz
昃	ze	or
笮	ze	vv
迮	ze	zv
箦	ze	vz
赜	ze	iz
舴	ze	vv
贼	zz	br
鲗	zz	yz
怎	zf	xv
谮	zf	yo
增	zg	tc
赠	zg	bc
缯	zg	sc
甑	zg	wc
憎	zg	xc
鄫	zg	ec
罾	zg	sc
矰	zg	uc
锃	zg	ji
综	zg	sz
䎖	zg	yc
炸	va	hv
渣	va	di
榨	va	mv
乍	va	pa
札	va	mg
闸	va	mj
诈	va	yv
眨	va	of
吒	va	kq
咤	va	kv
铡	va	jz
揸	va	fi
鲊	va	yv
砟	va	uv
楂	va	mi
劄	va	dd
哳	va	kv
霅	va	yy
拃	va	fv
溠	va	di
奓	va	dd
蚱	va	iv
挓	va	fv
柞	va	mv
痄	va	bv
䃎	va	ui
鲝	va	yy
齇	va	bc
债	vl	rz
窄	vl	xv
宅	vl	bq
摘	vl	fd
寨	vl	mb
斋	vl	we
瘵	vl	bj
豸	vl	pp
站	vj	lv
占	vj	bk
战	vj	gv
斩	vj	ij
沾	vj	dv
展	vj	uy
詹	vj	dy
蘸	vj	cj
栈	vj	mj
盏	vj	mj
毡	vj	mv
瞻	vj	ov
旃	vj	fd
绽	vj	sd
湛	vj	du
辗	vj	iv
鳣	vj	yd
鹯	vj	nd
飐	vj	fv
崭	vj	uv
栴	vj	md
谵	vj	yv
偡	vj	ru
搌	vj	fv
𫗴	vj	ud
张	vh	gi
章	vh	lz
涨	vh	dv
帐	vh	ji
账	vh	bi
仗	vh	rv
掌	vh	uk
杖	vh	mv
胀	vh	oi
丈	vh	ad
彰	vh	pv
障	vh	ev
蟑	vh	iv
璋	vh	wv
鄣	vh	ev
瘴	vh	bv
樟	vh	mv
漳	vh	dv
獐	vh	qv
嶂	vh	uv
幛	vh	jv
仉	vh	rj
嫜	vh	nv
暲	vh	ov
找	vk	fg
招	vk	fv
照	vk	dv
赵	vk	zi
兆	vk	ed
罩	vk	sv
诏	vk	yv
昭	vk	ov
着	vk	yo
棹	vk	mv
肇	vk	hy
沼	vk	dv
钊	vk	jd
曌	vk	km
爪	vk	pd
旐	vk	fv
笊	vk	vv
啁	vk	kv
𬬿	vk	jv
𬶐	vk	yv
这	ve	zw
者	ve	lo
浙	ve	dv
遮	ve	zd
哲	ve	kv
辄	ve	ig
锗	ve	jv
褶	ve	yb
蛰	ve	iv
辙	ve	iw
啫	ve	kv
柘	ve	mu
谪	ve	yd
蜇	ve	iv
喆	ve	jj
赭	ve	iv
磔	ve	uj
蔗	ve	cd
晢	ve	ov
詟	ve	ly
鹧	ve	nu
䗪	ve	iu
真	vf	uj
朕	vf	og
镇	vf	jv
帧	vf	jv
针	vf	ju
阵	vf	ei
枕	vf	mg
震	vf	yi
臻	vf	vq
珍	vf	wp
甄	vf	wt
贞	vf	bb
振	vf	fi
箴	vf	vx
缜	vf	sv
诊	vf	yp
斟	vf	du
侦	vf	rv
鸩	vf	na
祯	vf	uv
砧	vf	uv
赈	vf	bi
榛	vf	mq
轸	vf	ip
疹	vf	bp
桢	vf	mv
胗	vf	op
圳	vf	ti
畛	vf	tp
稹	vf	hv
禛	vf	uv
鬒	vf	iv
瑧	vf	wq
葴	vf	cx
揕	vf	fu
蓁	vf	cq
袗	vf	yp
浈	vf	dv
昣	vf	op
纼	vf	sy
正	vg	av
证	vg	yv
挣	vg	fv
蒸	vg	hv
整	vg	vi
症	vg	bv
争	vg	dy
郑	vg	eg
征	vg	xv
政	vg	wv
睁	vg	ov
筝	vg	vv
怔	vg	xv
烝	vg	hi
钲	vg	jv
铮	vg	jv
狰	vg	qv
拯	vg	fi
峥	vg	uv
诤	vg	yv
只	vi	kb
之	vi	dd
至	vi	tv
值	vi	rv
指	vi	fv
纸	vi	su
制	vi	dg
治	vi	dt
直	vi	aa
知	vi	uk
支	vi	uy
致	vi	wv
质	vi	bu
志	vi	ux
汁	vi	du
置	vi	sv
智	vi	ov
止	vi	aa
酯	vi	yv
职	vi	ev
执	vi	fw
掷	vi	fv
枝	vi	mv
痣	vi	bv
脂	vi	ov
趾	vi	zv
彘	vi	ab
织	vi	sv
吱	vi	kv
芝	vi	cv
跖	vi	zu
炙	vi	ho
滞	vi	dd
植	vi	mv
秩	vi	hu
旨	vi	bo
侄	vi	rv
栀	vi	me
徵	vi	xw
祗	vi	ud
陟	vi	eb
芷	vi	cv
窒	vi	xv
肢	vi	ov
址	vi	tv
雉	vi	uv
痔	vi	bs
祉	vi	uv
沚	vi	dv
枳	vi	mv
禔	vi	uu
栉	vi	mj
卮	vi	pe
稚	vi	hv
挚	vi	uv
郅	vi	ev
轵	vi	iv
畤	vi	ts
絷	vi	sv
帙	vi	ju
摭	vi	fd
蛭	vi	iv
鸷	vi	nv
铚	vi	jv
骘	vi	mb
埴	vi	tv
蜘	vi	iv
踬	vi	zv
帜	vi	jv
扺	vi	fu
贽	vi	bv
锧	vi	jv
踯	vi	zv
咫	vi	iv
觯	vi	jd
桎	vi	mv
滍	vi	di
泜	vi	dd
黹	vi	sd
轾	vi	iv
跱	vi	zs
忮	vi	xv
稙	vi	hv
疐	vi	pt
胝	vi	od
晊	vi	ov
庤	vi	gs
梽	vi	mv
榰	vi	mo
𦭜	vi	cv
𬃊	vi	mv
中	vs	aa
众	vs	rc
钟	vs	jv
终	vs	sd
冢	vs	bd
忠	vs	xv
肿	vs	ov
仲	vs	rv
盅	vs	mv
锺	vs	jv
柊	vs	md
踵	vs	zv
衷	vs	wy
螽	vs	id
舯	vs	vv
茽	vs	cv
周	vb	kj
轴	vb	iy
州	vb	id
粥	vb	gg
咒	vb	kj
肘	vb	oc
洲	vb	dv
舟	vb	pd
皱	vb	ip
昼	vb	id
纣	vb	sc
胄	vb	oy
骤	vb	mj
宙	vb	by
籀	vb	vl
酎	vb	yc
诌	vb	yi
绉	vb	si
帚	vb	jb
辀	vb	iv
鸼	vb	nv
赒	vb	bv
碡	vb	ud
婤	vb	nv
妯	vb	ny
荮	vb	cc
㑇	vb	ri
㤘	vb	xi
主	vu	dw
住	vu	rv
注	vu	dv
猪	vu	qv
煮	vu	dv
祝	vu	ux
著	vu	cv
朱	vu	pw
柱	vu	mv
渚	vu	dv
诸	vu	yv
助	vu	lq
驻	vu	mv
竹	vu	gg
诛	vu	yv
珠	vu	wv
株	vu	mv
铸	vu	ju
逐	vu	zu
筑	vu	vg
蛛	vu	iv
箸	vu	vv
邾	vu	ev
铢	vu	jv
烛	vu	hi
蛀	vu	iv
贮	vu	ba
嘱	vu	ku
拄	vu	fv
茱	vu	cv
炷	vu	hv
竺	vu	ve
伫	vu	ra
洙	vu	dv
纻	vu	sa
瞩	vu	ou
苎	vu	ca
麈	vu	lv
槠	vu	mv
舳	vu	vy
柷	vu	mx
疰	vu	bv
杼	vu	my
潴	vu	dv
侏	vu	rv
翥	vu	yv
砫	vu	uv
躅	vu	zi
蠋	vu	ii
橥	vu	mv
瘃	vu	bd
𬣞	vu	yv
抓	vw	fv
髽	vw	iz
拽	vy	fy
转	vr	iv
赚	vr	bj
专	vr	ad
砖	vr	uv
撰	vr	fg
篆	vr	vt
馔	vr	ug
颛	vr	ye
僎	vr	rg
啭	vr	kv
瑑	vr	wt
䏝	vr	ov
装	vd	yv
状	vd	jq
撞	vd	ft
庄	vd	gt
妆	vd	jn
桩	vd	mv
壮	vd	ju
追	vv	zv
坠	vv	td
锥	vv	jv
缀	vv	su
骓	vv	mv
椎	vv	mv
隹	vv	pa
赘	vv	ba
缒	vv	sv
惴	vv	xe
准	vp	dv
肫	vp	ot
谆	vp	yx
窀	vp	xt
衠	vp	xi
𬘯	vp	sx
桌	vo	mo
捉	vo	fz
啄	vo	kd
卓	vo	bu
浊	vo	di
灼	vo	hu
拙	vo	fi
斫	vo	uj
酌	vo	yu
叕	vo	uu
擢	vo	fd
濯	vo	dd
镯	vo	ji
琢	vo	wd
涿	vo	dd
汋	vo	du
倬	vo	rv
茁	vo	ci
浞	vo	dz
椓	vo	md
禚	vo	ug
诼	vo	yd
棁	vo	md
晫	vo	ov
䓬	vo	cv
䦃	vo	jv
𬸦	vo	nz
字	zi	bz
自	zi	pa
子	zi	aa
紫	zi	sc
资	zi	bc
籽	zi	mz
姿	zi	nc
滋	zi	dz
渍	zi	dz
梓	zi	mx
眦	zi	oc
姊	zi	nz
嗞	zi	kz
咨	zi	kc
恣	zi	xc
赀	zi	bc
訾	zi	yc
髭	zi	ic
笫	zi	vz
粢	zi	mc
缁	zi	st
孖	zi	zz
孳	zi	zz
觜	zi	jc
龇	zi	ic
孜	zi	wz
滓	zi	dz
辎	zi	it
淄	zi	dt
秭	zi	hz
镃	zi	jz
耔	zi	lz
嵫	zi	uz
鼒	zi	cd
虸	zi	iz
锱	zi	jt
趑	zi	zc
鲻	zi	yt
鄑	zi	ej
总	zs	bx
宗	zs	bu
纵	zs	sc
棕	zs	mz
粽	zs	mz
踪	zs	zz
鬃	zs	iz
腙	zs	oz
疭	zs	bc
倧	zs	rz
鬷	zs	gw
偬	zs	rc
走	zb	tv
揍	zb	fz
奏	zb	ft
邹	zb	ei
陬	zb	eq
驺	zb	mi
诹	zb	yq
鲰	zb	yq
鄹	zb	ej
组	zu	sq
足	zu	kv
族	zu	fu
租	zu	hq
阻	zu	eq
祖	zu	uq
俎	zu	qr
菹	zu	cj
镞	zu	jz
诅	zu	yq
崒	zu	uz
珇	zu	wq
钻	zr	jv
攥	zr	fs
纂	zr	vs
缵	zr	sz
躜	zr	zz
最	zv	oq
嘴	zv	kj
罪	zv	sf
醉	zv	yz
蕞	zv	cz
槜	zv	mj
尊	zp	cq
遵	zp	zz
樽	zp	mz
鳟	zp	yz
噂	zp	kz
撙	zp	fz
僔	zp	rz
嶟	zp	uz
𨱔	zp	jz
做	zo	rg
作	zo	rv
坐	zo	tc
左	zo	gu
座	zo	gz
佐	zo	rz
嘬	zo	kz
昨	zo	ov
唑	zo	kz
酢	zo	yv
祚	zo	uv
怍	zo	xv
阼	zo	ev
胙	zo	ov
捽	zo	fz
岞	zo	uv
